QUIZAS____: 分享 单曲   K 快乐   ( 网易 云 音乐 )   不 快乐 ！   
 咖啡爱上猫-corrine: 真的 好 累   儿子 撑下去 世界 五年 前 妈妈 感觉 活 大学毕业     十年   很多 爱 人 爱 人 想 力量 慢慢 去 保护 、 去 爱 到头来 发现 都 保护 不了 不了 别人 太多 爱 失败 输 很惨 可怜 还会       展开 全文 c 
 青二才小十: 推文   你养 猪 做 鸭 萧九凉 林向黎 家庭 原因 大学 退学 回家 乡 舅舅 安排 下当 一名 代课老师 母亲 病 表弟 唆使 当鸭 去 买 鸭 简 博士 养猪 老板 一段 努力 扮好 包养 角色 喜欢 上 奢求 爱 却 误会 只想 包养 默默 撑起 天       展开 全文 c 
 无常君cr: 看不到 一丝 阳光 乌云 一层层 不停 叠加 还 撑下去 未来 我会 人 好 想 问问 生活   
 _相葉豌豆酱: 较量 一个月 都 撑不下去 确实 办法 一个 人 生活 废物 信誓旦旦 行 每次 大事 小事 只会 哭哭啼啼 解决问题 方法 可笑 幼稚 不了 外卖 选择 不吃 天然气 坏 洗 冷水澡 天气 不好 不到 车 上班 请假 不去 上班 一个 没用       展开 全文 c 
 與爾同遊-: 小兮 小可爱 生日快乐 ！ ！ ！ ！ ！ ！ 天天开心 万事如意 平安 快乐 啵 啵 穿 秋裤   
 比比比斯鲁: 五月 青枫 : 93 级 ！ 不 62 级 高资   还 撑下去 
 宋城希CheneySong: 算算 這是 第四次 參加   越野跑 第三次 參加 25 公里 首次 挑戰 15.7 公里 獻給 merrell   水返 腳 兩棲 越野跑     很 幸運 都 平安 順利 完賽     ( 當然 受點傷 對 來 說 都 ) 兩年 後 回到 起點 這次 選擇 征戰   25.7 公里               老實 說 從 來 沒想過 我會       展开 全文 c 
 啊睿啊Aria: 每次 压力 大到 撑不下去 发 一发 wyj 丑照 舒服 ！   ！   
 糖糖曉扬: 快 不 快乐 32 年 真不容易 带 边框 拍   
 BombBon: 用户 不 改名 不行 : 喜欢 小光 都 说 快乐 从来 变 人间 温柔 本身 厉害 : 小乖 
 荞麦面和榴莲更配哦: 生日快乐 异次元 摆阵 主页 : 摆阵    心操 人 使     生日快乐 
 戏人老朽: 哥哥     都 近乎 崩溃 状态 下 度过     都 问     我能 撑下去     我能   支撑力 太小       选择     逃不掉   别人 每替 惋惜     更 疼       想想     我会 好受 点         （ 希望 不 小心 掉 进 沼泽地     明年 走 花路 ） 
 那举个栗子叭: 夏目君 生日快乐   
 藏起来的我hhh: 努力 克制 努力 控制情绪 努力 现状 往好 方向 发展 会 管不住 思想 情绪 安神 补 脑液 天天 喝 助眠 视频 一个 一个 看 不行 不 没人 懂 痛苦 说 矫情 压 真的 好累 好 累 白天 真的 控制 下 晚上 处于 崩溃 界限 撑 不下       展开 全文 c 
 Liens_t: 夏季   毕业 7 月 已 在校生 却 还 忙 学校 事情 毕业 一刹那 都 学习 、 工作 、 生活 里 毕业 仍 年少 毕业 快乐 无悔 芳华   2 武汉 · 湖北 警官 学院   
 吴冰雹:  studyaccount         高二 总算 结束 快到 期末 简直 快要 撑不下去 感觉 身体 快 支撑 不住         考完试 很多 事要 去 做 希望 高三 生活 顺利   
 吖咩咩-: 不想 复习 看 不 进去 背 不 进去 还 没 背 完 考试 竟然 撑不下去   
 早睡第一名_: 球球 真的 撑不下去 脑壳 疼得 连成一片 呼吸 发累 胸口 一团 闷火 捂着 耗着 一点一点 吃 干 抹 净   
 曼玉妹妹: 好好学习 小羊 爱 吃 酱 肘子 : 想要 爱 朋友 都 好好 ！ 回忆 专用 小 马甲 : 想要 快乐     花泽 美美 : 好好 赚钱 ！ 别想 没   M 大王 巡山 : 想要 都 拥有 得不到 都 释怀 苍南 派 : 快乐 工作 快乐 生活 ali _ thin : 求 减肥 Tiger 公子 : 再 生病 
 兔兔仙鹅: 真的 受不了 电视剧 演技 剧情 时间 线烂 坨   xz 颜撑 都 看不下去 真的 再 看 吐 称呼 乱 莫名其妙 机兄 就算 十几岁 蓝湛 含光君 几个 ？   
 嘟嘟说要做自己:  锦衣 之下 想 忘记 煎熬 还 七月 锦衣 会 ？ 一个 理由 快 撑不下去 O 网页 链接   
 是阿姝不是阿舒呀: 居然 熬夜 看 两集 cql 剧情 审先 不谈 服化 粉底 忍 演技 配不上 配音 撑住 毕竟 发现 肖战 真的 古装 颜值 巨 戳 ！ ！ fine 新 墙头 一个 肤浅 路 人 颜粉 这部 剧 mzy 不加戏 还 看   
 冰淇淋泡芙真的超甜: 这家 人 都 矛盾 都 解决不了 吵架 吵架 抑郁症 抑郁症 喝酒 家暴 不知 错 生活 毫无 盼头 真的 想 哭 糟糕 情绪 我该 撑下去   
 南粤国土著Anna: 快乐 回忆 专用 小 马甲 : 想要 快乐     花泽 美美 : 好好 赚钱 ！ 别想 没   M 大王 巡山 : 想要 都 拥有 得不到 都 释怀 苍南 派 : 快乐 工作 快乐 生活 雨 玲玲 zjl : 愿 努力 不负 期望 ali _ thin : 求 减肥 Tiger 公子 : 再 生病 
 Dawn_withJS: 清醒 一点 ！ ！ 回忆 专用 小 马甲 : 想要 快乐     花泽 美美 : 好好 赚钱 ！ 别想 没   M 大王 巡山 : 想要 都 拥有 得不到 都 释怀 苍南 派 : 快乐 工作 快乐 生活 雨 玲玲 zjl : 愿 努力 不负 期望 ali _ thin : 求 减肥 Tiger 公子 : 再 生病 
 徐家迷妹子-: 肯定 穿着 不合 脚 鞋子 苦 撑下去 早上 毅然决然 回家 换 双鞋 七月 苦尽甜来   
 pochiiiii: 六月 目前为止   大学 最苦 一个月   过边 吃饭 哭 中午   图书馆 差点 崩溃 中午     睡眠不足 脸色 暗沉 毫无 血色   一度 吃不下 饭   感受 不到 饥饿   姐妹 舍友 鼓励 撑下去   好 结束   说 很快   一个月 好 难熬   新 阶段   回到 回来 生活 轨迹     接下去 请 好       展开 全文 c 
 连s_MissLia: 都 不 两集 演个 烂 一句 话 全靠 忘 羡撑 看   
 深海呱子: 大 哥哥 生日快乐 鸭   
 Paco_Yao: 那次 冒险 半夜 上山   争拗 中 队友 不想 撑下去 尝尽 自由   感到 没趣   今日 推荐 《 任我行   -   陈奕迅 很长 时间 里 单曲 循环 歌 曲风 很 顺畅 一气呵成 感觉 之外 歌词 真的 很 值得 细细 去 琢磨 歌词 里 主角 从小 固执 倔强 追求 自由 长大 后 慢慢 学乖 变得 不再 勇敢 开       展开 全文 c 
 妮酱妮妮酱: 晚安 崽 崽 UNINE _ 李汶翰   李汶翰   0722 生日快乐 
 吖咩咩-: 不想 复习 看 不 进去 背 不 进去 还 没 背 完 考试 竟然 撑不下去   
 学森201509: 东叔 成名作 总 有种 读 不 感觉 反而 不 著名 倒 读 津津有味 撑下去 也许 很 好看   
 李应祺啊祺: 真的 快 撑不下去     
 山西头条资讯榜: 刚刚 一段话 特别 烦   先 冷静   看 一部 开心 电影   喝 一大 杯水   试图 朋友 聊天   朋友 分享 快乐 人   分享 痛苦 人   做 一个 唠唠叨叨 抱怨   从现在起   学会 去 化解   去 承受 送给 烦闷 人   
 密密麻麻在心口难言: 最 可怕 不动声色 崩溃 一层 薄膜 包裹 黑色 浓浆   一句 话 一个 字   力量 我快 撑不下去     好   
 朴燦花ww: 想念 严敏 感觉 鸡条 跑 男 感觉 男人帮 六人 + 严敏 才 极限 挑战 看回 鸡条 鸡条 就算 小猪 艺兴 黄磊 王迅 撑 看不下去 嘉宾 都 很 好 喜欢 原班人马 喜欢 极限 挑战 命   
 野鹿林兔: 终于 熬过 抑郁 崩溃 六月 都 迎来 2019 下半年 第一天 否极泰来 宠爱 精致 生活 做起 责任 持续 沙雕 快乐 ～   
 想吃樱桃的兔子: 快 撑不下去 不能不要 再 骗   
 凤凰涅槃舍我其谁: 快乐 
 rioota: 训练 饮食 都 控制 控制 精神 真的 最难 处 寻找 精神支柱 真 撑不下去 [ 捂脸 ] 女生 晒 肌肉 大赛   2 济南   
 大龄甜食中毒者: 广州 整整 一年 6 月 来说 离别 季节 带 爱 心来 不 爱 结束 不爱 不值钱 很 感慨 好像 快乐 曙光 真棒   
 神犬嘣叽: 正式 出 道 ！ 赚钱 ！ 健康 ！ scarborough - 想 做 富婆 : 好好 赚钱 攒钱 好好学习 看书 Shadowing _ Haven : 努力 工作 ！ 稳定 作息 ！ 春 小花 花 花儿 : 身体健康 森澤鈴 _ 腰酸背痛 : 努力学习   瞎 想 蓝原芽 衣厨 : 禁止 恋爱 结澄凛 : 严以律己 旧剑厨   : 健康 生活 苍南 派   : 快乐 工作 快乐 生活 
 大胃大无畏: 工作 快乐 ！ 财源滚滚 ！ 
 辣味儿的卤蛋: 好困 好多 消息 没 回 室友 说 走 太 负面 东西 不想 去 想 抱 今朝有酒今朝醉 态度 希望 明天 还 快乐 好 记忆 最 深刻 十二点 小镇 熄灯 那一刻 走 路上 明天 晚上 拍 星星   2 神农架林区 · 神农架 大九湖 国家 湿地 公园   
 安之若素Bindy: 说 没人信 努力 一只 狗 快 撑不下去 想到 狗 布丁 ～   
 糖炒栗子不加糖v: 夏影 : 国漫 频道 : 7.1 生快   微笑 日 推 _ 日常 : 生快 ！ 永远 爱 最 温柔 善良 走过 二次元 : 夏目 小天使 生快   永远 爱 掉 一只 龙猫 :   生日快乐 呐滋 咩 愿 七月 美好 
 呀呼嘿哈哈啦哦: 永远 懒洋洋 自由 向往 自由 勤奋 努力实现 更 广阔 人生 下半年 撑不下去 记得 这句 话   
 你看树上有只猪也:   怜爱   想起 小朱 上半年 差不多 状态   真切 列出来 行程 安排表 明白 咳复   一个 感冒 拖 半年   骂 公司 不 做人 红 代价   偶像 不温不火 这一说   抠 脚   刀山火海 千难万难 撑下去 ギ リ ギ リ   
 赫彻口渭糖迟控pan: 宣酒 6 上市 热销 一周年   生日快乐 预祝 大卖 铅笔 色 烟火 寂寞 无声 生活 沧笙 
 晚风是凉的: 林宥 嘉 0701 生日快乐     毛毛 太棒了 做 一个 超棒 生日礼物     祝 家鸽 天天开心 永远 自由 快乐 唱歌 享受 全宇宙 宠爱 
 宋宋宋小琦_: 宣酒 6 上市 热销 一周年   恭喜 小宣 生日快乐 祝福 小宣 越来越 好 越来越 火 花落 云忧 奇爷 驾到 紫水晶 中 夹 粉 
 始冰卍廿贰: 月 月初 都 说   月 会 好 月 月底 告诉 说 下个月 会 好   才 真的 好   撑不下去 Hello 七月   
 半糖ooslo: 长大 冷漠 低调 ； 寂寞 骄傲 会 快乐 多一些   
 颖颖会飞: 承认 我过 一点 不好 很多 真的 都 熬 不   快要 崩溃 不 压力 改变 都 太 好多 事情 真的 接受 不了   无力 抗拒 只能 哭 完 再 爬起来 老老实实 走 这辈子 从来 没 坚强 大小 坎 都 死 撑过去   
 每天都要开心和超级幸运: 纯粹 快乐 分享   温柔 遨游 
 早睡脱丧: 生日快乐   夏影 : 国漫 频道 : 7.1 生快   微笑 日 推 _ 日常 : 生快 ！ 永远 爱 最 温柔 善良 走过 二次元 : 夏目 小天使 生快   永远 爱 掉 一只 龙猫 :   生日快乐 呐滋 咩 愿 七月 美好 
 最没有原则的仙女: 真的 太 烦躁 太委屈 撑不下去   
 软软小懒: 粉上 半年 经历 很多 心累 会 想着 不 感觉 撑不下去 依旧 真的 放不下 喜欢 依旧 想 看着 依旧 舍不得 想 会 静静的 等待 默默 背后 做些 力所能及 事情 时光 不语 静待 花开   
 Ming明贼爱你: 始 始终 终 脆弱 撑不下去 人 都 一个   
 羽生柚子鹿: 夏瀚宇   阿楚 姑娘       夏瀚宇   不用 去 猜   夏瀚宇 说 辛苦 希望 快乐 ； 更 想要 夏瀚宇 快乐 UNINE _ 夏瀚宇 
 来自杨丽萍的微博: 人生 一场 心态 坐拥 家财万贯 野心 不死 终究 迎来 祸从天降 ； 两袖清风 知足 随缘 幸福 迟早 来临 人生 最终 目的 一生 快乐 幸福 钱财 名利 好 若要 快乐 幸福 交换 生命 境界 哭 降生 笑 遁世 人生 无常 得失 有常 心态 好 欢喜 失 不悲   
 Z9Ol2-为所欲mps: 心 简单 世界 简单 幸福 才 会 生长 ； 心 自由 生活 自由 都 快乐   
 暴躁网友佐佐木: 同理 学生 撑不下去 选择 休学 休学 未来 反而 明朗 亀 梨 穿 毛衣 等于 杀人 : 转发 微博 
 一林Fan:  电视剧 陈情 令 魔道淑芬 死忠 粉 当初 肖战王 一博 演剧 版时 看 还 去 看 帅帅 视频 看 肖战 剧照 接受 wyb 感觉 气场 撑 不 去 找 跳舞 视频 小 哥哥 跳舞 真的 帅死 （ 剧里 越往后 看越 ） 出 mzy 事后 真的 气死 会想 去 看       展开 全文 c 
 粒L麦提莎巧克力: 喜欢 現在 喜欢 现时 就会 活得 很快 樂 — —   鐘嘉欣   
 童心未泯www: 生活 不易 奔跑 前行 路上 沉浸 日复一日 忙碌 里 全家 生计 打拼 再 辛苦 ； 一次次 快 撑不下去 偷偷 告诉 再撑 好 人 努力 打拼 才能 越 走 越顺   
 澳洲制造AusMade: 人生 快乐 关键 看 知足 俗话说 欲壑难填 人 欲望 无止境 一种 欲望 还 会 更 欲望 滋生 欲望 太多太高 永远 得不到 快乐 不了 欲望 面前 换 一个 角度 去 理解 始终保持 一颗 平常心 看淡 升迁 ； 耐得 住 寂寞 抗得 住 清贫 O 网页 链接   
 lycorislonly: 確有 很多 更 艱苦 人 努力 生活 努力 過 這種 不想 活 無力 感為 什麼 還不走 不 去 看中 醫我媽 問醫生 吃 飯 沒 ？ 病人 這麼 很累 醫生 說 喜歡 事 運動 不喜歡 才 勞動 也許 他們 為 努力 人才 能撐 沒 說 後 父母 無動 於 衷 個       展开 全文 c 
 大邱草莓亨亨: 哈哈哈哈 哈哈哈哈 Chi 一摸 快乐 吃 草莓   问石 不答 : 哈哈哈哈 哈哈哈 颜 文字 君 : 感觉 去 趟 泰国 广东 人 ( ω ) 氪 爆 : 泰好 孝 既生 瑜 何弃疗 : 下 看 哈哈哈 山野 村夫 SusuPu : Prettycelery : YB 电饭锅 :   去 泰国 半年 香港 同事 口音   哈哈哈哈 哈哈哈 哈哈哈 
 叁贰芯: 中午 吃小面 味觉 不对劲 想想 吃 擀 面皮 擀 面皮 念 想 吞下去 半碗 面 转头 吃 韭菜 鸡蛋 馅儿 饺子 嚯 嚯 嚯 饺子 才 真 爱 ！ 已然 来不及 胃 小面 擀 面皮 撑满   
 棉花糖天空堂主: 宋仲基 颜值 撑 第八集 实在 看不下去 太 做作 、 太 难看 老年人 粉丝 骂 恕我直言   
 拉登爱布殊:  吴亦凡 [ 大 侦探 皮卡丘 微笑 ]   吴亦凡 中国 新 说唱   吴亦凡 代言 益达   委 委屈 屈 Mr _ 凡   想 抱抱 JULY - 吴亦凡 七月 快快乐乐 鸭 吴亦凡 首张 专辑   Antares ｜ 吴亦凡路 易威登   LV ｜ 吴亦凡 宝格丽 ｜ 吴亦凡 ACE ｜ beats 耳机 ｜ 小米 手机 ｜ 芝华士 ｜ IT 集团 ｜ 奔驰 smart ｜ 麦当劳       展开 全文 c 
 遇见我的人生灯塔: 发现 好 登西 ！ 哈哈哈哈 哈哈哈 哈哈哈 彭磊 太 有趣 快 考完 我要 本书 读完 看太有 负罪感 赶紧 考完 我要 疯 撑不下去 难熬 日子 还要 两周   
 豆奶拿铁超好喝: 李泰容 0701 生日快乐   _ Schlafen : 带 李泰容 0701 生日快乐 转发 本条 微博   明天 抽 一位 送 纳西 素 香水     30ml 祝崽崽 生日快乐 请 多多 喜欢 泰容 
 侯主中洪: 反转 甲等   舞台 体质   表情 管理   slay 全场   小小 眼睛 肚皮 消化 不良 食品 仓鼠   侠 姚琛 ！ 请 走     ！ R1SE - 姚琛 :  R1SE                     入住 新 家 快乐 ～     10 年   20 年   30 年 R1SE Family       Together   Forever           
 情話心說: zxc668   男人 唯唯喏喏 不吭声 妇人 叹 口气 道 放心 一日 夫妻 百日 恩 瘫 瘸 都 抛下 一个 妇人 这家 撑不下去 女人 说 说 呜呜 哭泣 男人 长长地 叹息 一声 道 小东 别哭 对不起 那心 留下 ？   
 ATsurreal: 一张 专辑 都 不知 反复 听 遍 都 数不清 1989 reputation 陪 度过 最 难受 快要 撑不下去 red speak   陪 度过 最 无忧无虑 fearless 里 穿着 长裙 公主 女孩子 美好 定义 都 太 珍贵 漂亮 孩子 抢走 张图 绷 不住 
 一点自闭: 原创 剧情 撑 不起 剧 配角 加 多戏 看 全靠 忘 羡   2 厦门 · 厦门 北站   
 左大大__: 人生 长久 难过 偶尔 快乐   
 酒窝里的小小生: 所有人 都 祝你快乐 只 愿 遍历 山河 人生 值得   一生 澄澈 清明 自由 洒脱 R1SE - 张颜齐 
 鲜子-GlLi: 七月 营业 宇宙飞船   : Pooh   : 失落 宇航员   : (     ) 七月 快乐 ！ 飞往 月球   : 乘坐 名叫 七月 宇宙飞船 承载 幸福 快乐 飞往 快乐 星球 
 小呆鱼儿爱吃糖LittleSun: 叶 幸运 叶 小宝 故事 : 换个 乐器 多事 接下来 多集 想想 片头 片尾曲 场景 撑下去 说 不 看 时 真香 他俩   锁住 毕竟 演员 拍 很 辛苦 
 Mongsin: 快要 撑不下去 
 Yiguasumlp: 事实证明 男人 撑 不起 心情 无论怎样 都 开心 不 年 感到 开心 几个 时刻 无一不是 学业 顺利 时刻 工作 不太 顺利 碰到 人 都 很 难 笑 这条 路太难 撑下去 孤独感 吞噬 再 想要 关系 走 太 偏   
 枕拣标兔晋臣: R1SE - 姚琛 :  R1SE                     入住 新 家 快乐 ～     10 年   20 年   30 年 R1SE Family       Together   Forever           
 QALTP糖: 多好 两个 蓝 孩子 [ 大 侦探 皮卡丘 微笑 ] 确认 眼神 去过 密室 逃脱 深厚 友情 都 快快乐乐 ～ 嗨 嗨 皮皮 ～ （ 讲小话 网线 拔掉 ） 
 用户6841422840: 诊断 出患 癌症 医院 天 台上 自杀 劝 哭 说 : 医生 都 说 康复 几率 微乎其微 不想 将来 病重 受苦 亲人 撑不下去 ！ 我爱你 放弃 ！   
 再来一杯绿茶: 不想 撑下去 好 累 感情 、 事业 、 生活 、 家庭 一个 人撑 真的 好 累 做 值得   
 赵湘云11596: 这是 ？ 好 艰难 快要 撑不下去   2 绵阳   
 等待阿狸的桃子Y: 谢谢 亲爱       休假 回来 带 浪     浪到 生日 回家 里       生日 回 我家         生日快乐   年 年 十八 女生   2 玉林 · 玉林 火车站   
 七月的米巫婆: 今日 监考 同事 哭穷 说 去年 买 一套 一百八十 平 房子 后 没 钱 转瞬 说 实在 撑不下去 就让 老爹 老妈 老家 五 套房 卖 一套 好   
 小胖猫的少女心: 人 一生 快乐 难过 ！   2 儋州   
 T好心晴T: 手机 忘 公司 脑袋 初老 症状 记性 变好 差 肚子 去年 撑起来 再也 脸上 镜子 都 不想 美颜 盖 不住 道 道   2 绍兴   
 眼镜怎么就坏了呢: 撑 大概 两个 星期 不得不 承认 网剧 橘生 淮南 真的 令人 失望 剧版 暗恋 导演 东宫 导演 看过 东宫 真的 危机感 真的 想 站网 剧 都 看不下去   
 潘小胖要天天开心: 过不下去     车该 开   喜欢 摄影 学   工作 撑   ...... 着急 慢慢来   着急   慢慢来 着急   慢慢来 想要 都 会   
 李小盼盼肀盼盼: 宣酒 6 上市 热销 一周年   祝福 宣酒 生日快乐 和蔼 牛肉 白白 小蕊 戴 竹 娜娜 爱勋 
 罗罗薇安: 好 累 好 累 真的 快 撑不下去 放过   
 暮暮_行雨: 三无 大王 巡山 :     一个 字 ！ 刘码 露 : 这才 只播 区区 两天 下周一 二三 加播 两集 好 累 好 快乐 翛 翛 : 害 ！ 我刚 去 突击检查 下 截止 23 点 30 分 投稿 日期 6 月 30 日 陈情 令 视频 854 陈总实 红 
 帐中妖和枕边猫: 走 人 一个 不 走 该留 人 撑不下去   
 Yiguasumlp: 事实证明 男人 撑 不起 心情 无论怎样 都 开心 不 年 感到 开心 几个 时刻 无一不是 学业 顺利 时刻 工作 不太 顺利 碰到 人 都 很 难 笑 这条 路太难 撑下去 孤独感 吞噬 再 想要 关系 走 太 偏   
 孤久厌闹i82977: 还 想 大不了 哭 一场 硬着头皮 爱 世界 缘分 不 缘分 都 撑     L 孤久 厌闹 i82977 微博 视频   
 追风少女森绘梨佳: 听说 上午 偷吃 猫 粮 撑 午饭 都 吃 不 ？ ？ ？ （ 肚子 撑 ）   
 酱子吖516: 这部 剧 场景 切换 剪辑 真的 很大 ！ 港真 路 人 真的 看不下去 撑 真的 看忘羡 一博 打戏   
 nxxyeah: 想 干 文职 感觉 肉体 撑不下去 看 电脑 感觉 脑子 都 炸   
 小呆鱼儿爱吃糖LittleSun: 叶 幸运 叶 小宝 故事 : 换个 乐器 多事 接下来 多集 想想 片头 片尾曲 场景 撑下去 说 不 看 时 真香 他俩   锁住 毕竟 演员 拍 很 辛苦 
 袁子袁邦: 人 说 异地 恋 会 分开 异地 恋 不 等同于 分手 坚持下去 世界 上 跑 赢 时差 撑 距离 爱情   
 山树有相逢: 爱慕 值   owhat 记录 hyq 删   一笔 都 会 hyq 设置   橘子 数据 撕 逼 没 一手 抓 莫 比比   没人能 阻止 快乐 追星   
 只只曉彭: 刚刚 好 搬 砖 一个月   我爸 每次 发 视频 都 会 问 有没有 钱   没钱 说   每次 都 死 鸭子 嘴硬 说 上次 还 说 不好意思 都 养 多年 大 不在乎 一下子 感动 实在 撑不下去     说 没 钱   我爸 给我发 两百   结束 没想到 隔 一小 会 连发 两个   我以       展开 全文 c 
 打个摩的见花花: 人 不 中途 弃剧   shn     再厚 滤镜 再 撑下去   
 明俭鑫4: 张艺兴 卷发 「 真的 撑不下去 」 啜泣 脸 埋进 双手 拍 肩膀 鼓励 「 撑下去 ！ 难道 忘 时 我俩 许下 誓言 ？ [ 手套 ] 300 一个 人 自助餐 ！ 」   
 用户6851256873: 约 吃 甜品 看 电影 始终 进一步 动作 连好 几次 碰到 手 都 牵 天下 小雨 撑 伞 散步 想 笨蛋 不 主动 ？ 路过 小桥 时 折起 伞 扔 河水 里 愣住 笑 说 一个 人 淋雨 恍然大悟 咻 一声 伞 扔下去   
 逃避诗: 真的 一段时间 放空       快 撑不下去         
 __大L: 立着 一个 做饭 形象 偶尔 炒 一个 菜 会 赞不绝口 撑 一个 能带 孩子 形象 从带 一个 升级 带 两个 却 从来 一句 辛苦 都 换 不到 ... 生 娃 跪 带 每每 天天 都 细小 事情 压 筋疲力竭 朋友 聊天 解压 宽慰 说       展开 全文 c 
 红烧肉与酸豆芽的爱情: 哈哈哈哈 哈哈哈 下 岳岳 带 兄弟 女 嘉宾 吃饭 兔子 屁股 软乎乎 : 好 快乐 ONER - Only 资源 博 :  oner ONER   舞会   天天向上 下 周日 晚 10 点   期待 ONER ONER 
 单Genius: wow 看 韩剧 啊啊啊   听见 声音 简直 消除 韩剧 偏见 .... 最 讨厌 电视剧 感觉 bbbbb   感觉   妈   绝   太棒了   简直 爱死 李宝英 姐姐  李宝英 李钟 硕 腿   尝试 看 太阳 后裔   第五集 撑不下去 ... 感觉 太 无聊       展开 全文 c 
 氟西汀Fluoxetine__: 真的 撑不下去 头疼 好 几天 熬夜 昨天 通宵 考试 都 后天 护导 书 依旧 白白胖胖 我该 好 想 回家 我要 不行   
 用户6846078303: 约 吃 甜品 看 电影 始终 进一步 动作 连好 几次 碰到 手 都 牵 天下 小雨 撑 伞 散步 想 笨蛋 不 主动 ？ 路过 小桥 时 折起 伞 扔 河水 里 愣住 笑 说 一个 人 淋雨 恍然大悟 咻 一声 伞 扔下去   
 桥头种绿萝: 快乐 加班 本地人 喵 喵 机到 开心 孩子 考完试 找 串门 那学 上 必修 魔鬼 超 快乐   
 陈伯如:  林宥 嘉     yoga 生日快乐 长生不老 Yeah ！   
 文丽妮子: 撑不下去 心情 烦躁 迷茫 就读 一遍   1 清醒 时 做事 糊涂 时 读书 大怒 时 睡觉 独处 时 思考 2 再 难 再 好 淡泊 再 差 再 节省 3 路 不必 别人 标准 框定 人生 4 才华 撑 不起 野心 时       展开 全文 c 
 EachOfYou: 时期 其他人 都 结婚 分开 说 两天 充实 地像 半年 不想 离开 撑不下去 笑 几天 过得 痴痴 醉醉 上次 好好 5 年 那年 大一 都 刚 聊 初中 上学时 趣事 放下 骄傲 带 一身 疲惫 一个个 好 姑娘 感情 路上 跌       展开 全文 c 
 用户6138612143: 望穿 秋色 凝波 事情 发生 2018 年 十月份 浙大 博士 失踪 只 留下 一份 遗书 四天 后 钱塘江 打捞   浙大 博士 跳江 自杀 孩子 撑不下去 几张 图 ！   O 网页 链接   
 啵_是熊憨憨呐: 天使 特儿 ~ 生日快乐 ~ 超级 爱 带 哥哥 E l f 陪 走 朴正洙 0701 生日快乐 
 明处除扫卧: 翟潇闻 快乐 方式 很多 最 见到   不好意思 一不小心 喜欢 都 砸 身上   R1SE - 翟潇闻   R1SE - 翟潇闻 :  R1SE     
 幻以诺: 自闭 撑 很 久 最终 某天 深夜 撑不下去 不 难过 不好过 还 白天 挺 好 晚上 要死 白天 不想 活下去 都 一瞬间 做 爱与恨 一瞬间 再 做 一瞬间 脑袋 像是 光速 回忆 发生 事 直觉 判断       展开 全文 c 
 梦瑶小可爱-3-:   啥时候 娶 结束 异地 恋有 好 几次 都 撑不下去 看 哭   L 梦瑶 小可爱 - 3 - 微博 视频   
 张小辫儿和杨九郎: 快乐 
 嘻嘻你也来吗: 不 喜欢 大 帅哥 葡 沢 : D 社连 两条 推特生 贺 + 更换 多个 平台 背景   还 做 饭制 视频   像是 宣誓 主权 炫耀 宝贝   容儿 帅 
 略略宝Y: 努力 快乐 总有 最 亲近 人 最 沉重 打击 也许 有天 撑不下去 真的 解脱   
 三两合欢: 高中 用过 一个 软件 湖畔 模式 很 舒服 app 说 下架 下架 零星 导出来 数据 忘 用米 田 真的 换 手机 必备 app app 苹果 手机 定期 上线 刷 更新 看遍 开发人员 介绍 担心 运行 会 将来 撑不下去 还 发过 信息 感谢 辛苦 加油 
 今天也要愛老何: 撑不下去 想 妈换 手机   还 撑 ！ ！ ！ ！   
 树天天: 顺利 好 回忆 专用 小 马甲 : 想要 快乐     花泽 美美 : 好好 赚钱 ！ 别想 没   M 大王 巡山 : 想要 都 拥有 得不到 都 释怀 苍南 派 : 快乐 工作 快乐 生活 雨 玲玲 zjl : 愿 努力 不负 期望 ali _ thin : 求 减肥 Tiger 公子 : 再 生病 
 阿过今年是最后一次改名机会了: 快乐 追星   
 不要问此博主是谁问了也不告诉你: 希望 恋爱 自愿 扮作 英雄 去 保护 勋章 不 留给 撑下去 傲然 笑 挡 兵器   
 明处除扫卧: 翟潇闻 快乐 方式 很多 最 见到   不好意思 一不小心 喜欢 都 砸 身上   R1SE - 翟潇闻   R1SE - 翟潇闻 :  R1SE     
 山己木: Grace _ 阿泽 : ssong _ ssong : 喜欢 禹智皓 真的 只 快乐   身上 体现 一个 人 梦想 样子   经历 很多 不好 事情   都 停滞   做 喜欢 事   开 公司   名片   不 别人 而活   人生 很多 很酷 很 厉害 经历   很 乐意 欣赏 他创 
 安杰拉在尼比鲁: 去 wasaga   beach 总 wasaga 这名 一点 都 不 英语 为啥 湖边 会 小 松树 大包 小裹 买 一堆 零食   一顿 KFC 吃 撑   零食 塞 不 Canada   Day   
 0opps: 七月 包含 喜欢 人 诞生 日子 特别 特别 棒 月份 会 顺利 快乐   
 Arri_eleven: 高集 酒窝 清   「 真的 撑不下去 」 啜泣 脸 埋进 双手 拍 肩膀 鼓励 「 撑下去 ！ 难道 忘 时 我俩 许下 誓言 ？ 300 一个 人 自助餐 ！ 」 故三阴 离合 太阴 为开   
 球球球rach:     快乐 ！ love     love   
 酷爱POLO端: 快乐 快乐 
 愚童__: 解决不了 事情 应对 不了 ！ 糟糕 2019 年 ～ 本身 一个 无比 悲观 人 负 能量 整体 充斥 命运 生活 还 一次次 捉弄 有时候 都 崩溃 想想 家里 一个 撑下去 ！ 好 累 真的 累 ～   
 小文的一生: 7 月 1 不到 六点 起床 早上 收拾 好 站 会 碗 吃完饭 收拾 屋子 很多 不必要 做 事 还好 早饭 合胃口 鸡蛋 咸菜 玉米 一上午 站   走   跑 干 干过 事 午饭 本来 想着 吃不下 一吃开 好像 吃 最 躺 撑 还 量 刚 合适       展开 全文 c 
 大白兔小先森: 有时候 真的 不想 撑下去 想到 在家 平安 回来 会 想 办法 坚持下去   
 我不想这样D9: 别人 快乐 慈悲 快乐 智慧   
 superlinux华: 男生 女生 眼中 蜘蛛侠 等待 下课 等待 放学 等待 童年 童年 歌谣 依旧 长大 何不 抛 下 生活 重负 重温 儿时 快乐   
 集藏月亮-: 小 郑   濒临 极限   撑   使 不至于 倒塌   姿势 维持下去   好 难受 好 委屈   
 法克low逼们: 吃 吃 大 面包 分 三次 吃 居然 一口气 两次 吃 完 撑 脚板 早上 不爽 压下去 难受 走路 多压 几下 舒服 点 保健 保健 买 神灯 天天 在家 热敷 按摩 膏   
 毛猴敲酒: 真的 好 可爱 ！ ！ ！ 节目 无聊 撑不下去 吃 吃 四顿 : 13 年 宝宝 
 17拾壹: 想 大概 撑不住 太久 一味 万念俱灰 大不了 楼上 跳下去 一了百了 站 九楼 阳台 树 郁郁葱葱 想 飞下去 树枝 尖锐 刺透 身体 念头 发抖 害怕 求生欲 想 活着 世人 只 矫情 拥有 健康 身体 却 不 爱惜 偏偏 浪费 生命       展开 全文 c 
 桃子先生幼稚鬼: 夏目 大人 治愈 系 - 夏目 友人 帐 : 0701 夏目 贵志 生日快乐   开心 呐 小顾 同学 背 日语 :   喜欢 夏 目的 第六年   温暖 如初   夏目 生日快乐   0701 夏目 贵志 生日快乐 
 AfterThen-: 六月 七月 跨 半年 钱 总 生日快乐 都 心想事成 噢   
 赵湘云11596: 这是 ？ 好 艰难 快要 撑不下去   2 绵阳   
 Allen-Chenrr: 生日快乐 林宥 嘉 YogaLin   
 一只脾气暴躁的小火龙: 养成 一到 下午 四五点 困到 灵魂 出窍 不 睡觉 撑不下去 习惯 ？ ？ ？   
 甜甜荃儿: 终于 结束 一个月 学习   想想 前 几天 累 委屈   好像 好久好久   撑不下去 努力   天生 乐观   只不过 强迫 咬咬牙   早上 吃 不了 饭 只能 啃着 昨晚 面包   最 难过   好多 人 理解 不了 难 说 活不下去 转 锦鲤   背书         展开 全文 c 
 颖颖会飞: 承认 我过 一点 不好 很多 真的 都 熬 不   快要 崩溃 不 压力 改变 都 太 好多 事情 真的 接受 不了   无力 抗拒 只能 哭 完 再 爬起来 老老实实 走 这辈子 从来 没 坚强 大小 坎 都 死 撑过去   
 wxf_203: 想念 严敏 第一期 播 还 发微 博说 极 挑 一如既往 搞笑 还 劝 网友 都 看不下去 感觉 极 挑 几个 人 死撑 丧失 点开 冲动 颜王 再 美 都 再 挽回   
 426一元scramble: 生日快乐 
 木木是只小馋猫: 老子 连约 好 小姐姐 都 没 去 医院 陪 三天 治疗 猫 瘟 敢 撑不下去 老子 绝逼炖 野猫 野狗 ！   
 小绵龙的麻麻YanRAD: 初恋 追星 没想 初恋 不 进来 实际上 错过 苦撑 时期 越 越 喜欢 、 越 回顾 越 坚定 办法 ？ 只能 庆幸 走 
 圈梨梨: 右边 棒 仔 小 世界 : 早睡早起   开开心心   重联 旧友     夏目家 小 诗哥 : 家人 健康 平安   顺顺利利 苍南 派 : 快乐 工作 快乐 生活 雨 玲玲 zjl : 愿 努力 不负 期望 ali _ thin : 求 减肥 Tiger 公子 : 再 生病 
 寒先生·: 前塵 往事 杯酒 七月 快樂   
 18级艺科四班: 七月 快乐 太久 没发 微博 敷衍   2 成都   
 肥宅腰围: 止损   回忆 专用 小 马甲 : 想要 快乐     花泽 美美 : 好好 赚钱 ！ 别想 没   M 大王 巡山 : 想要 都 拥有 得不到 都 释怀 苍南 派 : 快乐 工作 快乐 生活 雨 玲玲 zjl : 愿 努力 不负 期望 ali _ thin : 求 减肥 Tiger 公子 : 再 生病 
 QYQQQOO: " Take     time 用户5508185737: 心情 超级 差 别人 轻易 事 ？ 却 努力 2 年 都 不行 身体 每况愈下 生病 才 健康 多么 宝贝 找 真的 好 累 快 撑不下去   2 成都   
 砍妹藏起来: 放 轻松 ..... 小羊 爱 吃 酱 肘子 : 想要 爱 朋友 都 好好 ！ 回忆 专用 小 马甲 : 想要 快乐     花泽 美美 : 好好 赚钱 ！ 别想 没   M 大王 巡山 : 想要 都 拥有 得不到 都 释怀 苍南 派 : 快乐 工作 快乐 生活 ali _ thin : 求 减肥 Tiger 公子 : 再 生病 
 pochiiiii: 六月 目前为止   大学 最苦 一个月   过边 吃饭 哭 中午   图书馆 差点 崩溃 中午     睡眠不足 脸色 暗沉 毫无 血色   一度 吃不下 饭   感受 不到 饥饿   姐妹 舍友 鼓励 撑下去   好 结束   说 很快   一个月 好 难熬   新 阶段   回到 回来 生活 轨迹     接下去 请 好       展开 全文 c 
 鹿芦贝贝: 减肥 成功     回忆 专用 小 马甲 : 想要 快乐     花泽 美美 : 好好 赚钱 ！ 别想 没   M 大王 巡山 : 想要 都 拥有 得不到 都 释怀 苍南 派 : 快乐 工作 快乐 生活 雨 玲玲 zjl : 愿 努力 不负 期望 ali _ thin : 求 减肥 Tiger 公子 : 再 生病 
 象巧欣:   猫咪 带来 快乐     
 我是酸木瓜: 大 早上 拖起来 撑 伞 去 升旗 早起 傻 很困 一点点 都 复习 不 满脑子 睡觉   
 夏洛特之梦: 金 掌勺 11 岁   生日快乐 萌萌 喵 V5 
 小丑还有只汪: 做 想 做 事 ！ 记得 ！ 小羊 爱 吃 酱 肘子 : 想要 爱 朋友 都 好好 ！ 回忆 专用 小 马甲 : 想要 快乐     花泽 美美 : 好好 赚钱 ！ 别想 没   M 大王 巡山 : 想要 都 拥有 得不到 都 释怀 苍南 派 : 快乐 工作 快乐 生活 ali _ thin : 求 减肥 Tiger 公子 : 再 生病 
 Teresa高小亚: 夏天 却 扭过头去 看不见 理想 生活 之间 距离 不 明白 远 撑下去 K 理想 人 不 伤心   
 霍格沃兹高级魔法师: 后悔 中 度过   偷懒 做 优秀 人 回忆 专用 小 马甲 : 想要 快乐     花泽 美美 : 好好 赚钱 ！ 别想 没   M 大王 巡山 : 想要 都 拥有 得不到 都 释怀 苍南 派 : 快乐 工作 快乐 生活 雨 玲玲 zjl : 愿 努力 不负 期望 ali _ thin : 求 减肥 Tiger 公子 : 再 生病 
 开心De羊:  凉山 救火 英雄   王佛军   生日快乐   爱笑 小朋友   都 开开心心   好好 照顾     生日快乐               L 开心 De 羊 微博 视频   
 我的西皮可能每天都很甜: 快 到期 快要 撑不下去   
 密码0216: 坚强 男人 撑不下去 会想 妈妈 想 妈妈 哭 想 回家 诉说 妈妈 一个 灵魂 港湾 内心 无处 安放 委屈 寄托 世界 没 世界 到底 善良 无情 吞噬 孝心 物质 磨灭 友情 利益 绑架 爱情 角落里 哭泣 世界 会 好   ( 未来 版 )   [ Live ]       展开 全文 c 
 潘潘丨潘小小潘: 宣酒 6 上市 热销 一周年   祝小宣宣 生日快乐 ！ 销量 长红 秋日 荼空 林夏颜 好 一个 吴亦凡 
 还还还阿蛮: 很多 真的 都 熬 不   快要 崩溃 不 压力 改变 都 太 好多 事情 真的 接受 不了 无力 抗拒 只能 哭 完 再 爬起来 老老实实 走 这辈子 从来 没 坚强 大小 坎 都 撑过来   
 张顺航Zachary: 承认 我过 一点 不好 很多 真的 都 熬 不 快要 崩溃 不 压力 改变 都 太 好多 事情 真的 接受 不了 无力 抗拒 只能 哭 完 再 爬起来 老老实实 走 一个 人撑 别无选择   
 云吞汐: 水 森林 真的 看不下去 开场 半小时 后 一次次 看 表 感到 头大 想要 离场 硬撑 看 完 矛盾 转折 高潮 在我看来 戏剧 色彩 听 演后 谈 反而 感觉 演后 谈比剧 更 价值   看剧 多年 第一次 理论知识 撑 不起 荒诞派 台词 表现 哲理性       展开 全文 c 
 京红领: 中美 两国 建交 40 年来 发展 成 我中有你 你中有我 离不开 状态 有时候 生气 吵架 样子 挺 吓人 很快 会 烟消云散 都 长期 撑下去 紧张 关系 中国 国家 经贸关系 交恶 交恶 很 长时间 都 很 难 恢复正常 话 中国 加拿大 关系   
 dis_away: 感觉 撑不下去 想想 舒服 点 找个 简单 工作 钱 钱 少 无所谓 下 班宅 家里 玩玩 手机 剧 过个 两年 将就一下 找个 喜欢 人 嫁 行 努力 一点 不 学习 都 搞不定 真的 一辈子 还 早点 死 放弃 人 我要 久       展开 全文 c 
 Tronrto: 舍友 陆陆续续 身体 小毛病 一个 喉咙痛 一个 感冒 发烧 第一 时间 去 解决 拖 想想 高三上 学期 明明 感觉 发烧 感冒 无力 持续 几天 硬是 感觉 还 撑 撑 药 不怎么 吃 撑 一个 星期 才 好 鬼 身体 熬过 高三 下学期 喉咙 发炎 连续 几天 越       展开 全文 c 
 夏小末嘚小屋: 不 30 年 活 撑不下去   2 晋中   
 看看都吃的是啥啊: 李盒 崽 : 少女 总统 利特 儿 生日快乐 利特 0701 生日快乐 
 Stargazer空想家: 一个 资深 宅 与世隔绝 ？ 大火 巨人 喰 种 re0 实在 没 好看 没 看 看 几集 实在 撑不下去 弃 先说 巨人 军国主义 洗脑 根本无法 接受 喰 种 不 好看 说 题材 不 接受 确实 生存 猎奇 食人 都 写 烂 生存 real   account       展开 全文 c 
 用户7061289074: 难道 传说 中 爱民如子 ？ 感觉 快 撑不下去 
 菜菜菜菜菜菜sj夫人: " 年 依然 翩翩公子 一如 初见 就让 陷入 朴正洙 生日快乐 利特 0701 生日快乐   朴正洙 0701 生日快乐     Sj - special1004   九八不动产周刊: 经济型 可靠性 低噪音 三个 都 不 协和 撑不下去 京畿 盗图 大 魔王 : 边境 计划 firefly : 有钱赚 麻 
 -不要乱来: 才 第一天 感觉 撑不下去   
 Gynnn君_: 国内 音乐剧 高贵 人 发展 不 不 公司 赔钱 做剧 撑不下去 暴躁 过气 选手 : naccifuckyouall : 晕 满嘴 自诩 高贵 恶臭 熏得 一个 激灵 竟然 高贵 人 看 音乐剧 三生有幸 
 沙雕小兄弟: 感觉 快 撑不下去 灰心 更 糟心 事儿   
 杨小轩6047275680: 持家 老铁     生活 压力 好大 手机 7 年   感觉 我快 撑不下去 
 强省slave舜儿: 辣条娘 : 怕   勇敢 一点 好 一点 M 大王 巡山 : 想要 都 拥有 得不到 都 释怀 苍南 派 : 快乐 工作 快乐 生活 雨 玲玲 zjl : 愿 努力 不负 期望 ali _ thin : 求 减肥 Tiger 公子 : 再 生病 
 堂本_LTVXQ: 自诩 老剧粉 好歹 一个 从小 学习 古典音乐 至少 去 听 一场 交响乐 初中 就入 音乐剧 坑 人 巴不得 多点 人进 剧场 看 各种类型 剧 怕 哪一天 剧院 撑不下去 倒闭 南京 场 写给 人 信里 都 说 谢谢你们 更 人 走进 剧场 恨不得 声 人写 八百 封信 谢谢 推广       展开 全文 c 
 灿妹儿canmeier: 才 没用 垃圾   诊断 出患 癌症 医院 天 台上 自杀 劝 哭 说 : 医生 都 说 康复 几率 微乎其微 不想 将来 病重 受苦 亲人 撑不下去 ！ 我爱你 放弃 ！   
 sunXkun: 好 快 都 下半年 半年 好像 等待 中 度过 包括 刚刚 癫疯 之夜 苦 快 一个月 都 崽 崽 很多 事 工作 很 忙 猫 生病 离世 大大小小 烦心 事情 都 快 撑不下去 好像 还行 份 割舍 依赖感 反而 更 勇气 面对 事情       展开 全文 c 
 星星县的阿狸: 休 一周 再 上班 心情 沉重 浑浑噩噩 点数 起床 刷牙 打理 看着 乱糟糟 房间 想着 即将 面对 人和事 撑不下去 这份 工作 带给 期待 化为 逃避   
 HEE澈澈澈澈啊: 特儿 生日快乐         
 也没有很慌: 有感而发 《 shang 瘾 看 好尬   演员 尬 剧情 尬 台词 尬   会 好   看 两集 撑不下去 ... wyb 好绝 男 （ 暴风 流泪 ）   
 查無此人sor: 金秀贤 正式 退伍 九句 话 撑不下去   
 朱戬替我宠查杰: 查杰 0814 出道 周年 快乐     查杰 天理 男容   - 查杰 -   不 小心 错过 世界 最 灿烂 时间 线 便 黯然失色 明星 势力 榜 233 位     
 Deja_Vu郑因成中文站:  郑因成 郑因成 0701 生日快乐   190701   官 推 更新 [ 熙俊 ]   可爱 因成 生日快乐     
 Allvww: 几天 调节 失败 快 撑不下去   
 jeson刘: " 收拾 明天 东西 放 出租屋 就行了 都 没错 做 不好 太 极端 回家 好好学 暑假 去 目标 院校 转转 感受一下 同龄人 努力 peer     pressure ! 经历 事 来说 成长 激励 生活 不 开心 成功 不远 a   smile 水晶心214: 蛋糕 超级 漂亮 味道 不错 胡彦斌 出 道 二十周年   胡彦斌 0704 生日快乐 
 K-暮暖: 颜值 真的 正义 男主 颜 撑 着想 看 完整 部剧 ？ 理解能力 男女 主 感情 线 好迷 感觉 女主 智商 不 在线 女二 更 希望 男主 喜欢 ？ 希望 女主 配置 青梅竹马 诶 男主 喜欢 好 看不下去       展开 全文 c 
 默哀心底: 我俩 关系 全靠 硬撑   终于 撑不下去   祝 越来越 好   
 情話心說: zxc668   男人 唯唯喏喏 不吭声 妇人 叹 口气 道 放心 一日 夫妻 百日 恩 瘫 瘸 都 抛下 一个 妇人 这家 撑不下去 女人 说 说 呜呜 哭泣 男人 长长地 叹息 一声 道 小东 别哭 对不起 那心 留下 ？   
 我要当项目经理: 好 难 太难 真怕 撑不下去   
 朱可爱的林天地:  张杰 真的 特别 感同身受 喜欢 杰哥 九年 都 是因为 没钱 去 看 演唱会 上 大学 攒钱 去 看 一场 演唱会 最远 位置 超级 开心 超级 激动 超级 感动 永远 都 忘不了 那天 快乐 泪水 说好 唱 听 希望 阿杰 娜姐 跳跳 俏俏 天天开心 都 好 
 mmuuup: 朝夕相处 十几天 难过 第一次 带课 带课 肩负着 小可爱 上岸 愿望 才 撑 前程似锦 不 说 只 希望 未来 领导 好好 发光 发热 初心 ~   
 Bacchus财务IvanWu: 转     天天 快报   《 浙大 博士 跳江 自杀 孩子 撑不下去 15 张 照片   ! 生活 不易 人 睁开 双眼 便 咬牙 撑过 今日 份 痛苦 依然 坚强 想 一死了之 看着 疼爱 人 咬牙 撑   O 微信 扫 一扫   下载 天天 快报 客户端   
 文酱很靠谱: 快 撑不下去 好 一点 ！ ！ 
 encounter晨曦: zxc668   杨浩 摇头 道 一鼓作气 ？ 攻城 之战 哪有 三天 五天 十天 半月 ？ 连番 大战 之下 兵 铁打 哪有 不累 不乏 再者说 刚刚 招纳 降兵 扩张 大 地盘 大 一块 肥肉 吞下去 总得 稳 稳妥 妥地 化作 腹中 食物 才 好 想要 一口 吃 成个 胖子 还 不 撑   
 一霎灯前醉: 太 难看 太 难看 靠着 帅哥 颜值 都 快 撑不下去   
 重新遇见了你: 我快 撑不下去 开心 不 开心 装作 开心 在乎 人 就要 吵架 扬言 离开 ？   
 用户57o201282324: 小南 生日快乐 
 遇见我的人生灯塔: 发现 好 登西 ！ 哈哈哈哈 哈哈哈 哈哈哈 彭磊 太 有趣 快 考完 我要 本书 读完 看太有 负罪感 赶紧 考完 我要 疯 撑不下去 难熬 日子 还要 两周   
 Hd先情8_y: 内心 总有 块 柔软 地方 留   一触 碰到 会 妥协   很会 口是心非   真心 希望 开心 快乐   
 ABC别想太多: 多么 硬 都 不得不 低头 好 恨 两个 声音 一个 真的 受够了 趁早 快刀斩乱麻 一个 再 坚信 老天 考验 撑下去 卡 蛋 动 疼 不动 持续 疼   
 灵魂归墟: 感觉 生活 撑不下去 想想   还 撑下去 
 记录无聊的日常: 放下 外 物 活 开心 一点 感觉 我快 撑不下去 假装 开心 真的 很累 没人 懂 很 累 感觉 一个 极端 陷入 一个 极端 亲情 、 友情 、 爱情 都 不在乎 好   
 Yourbabypiggggggg: 撑不下去 真的 撑不下去 男朋友 电话 还 不通   
 __子昆: 真的 懒得 纠结 一口 薯片 卡路里 反正 姥子 长 样子 胖点 瘦点 都 没 影响 一张 胖脸 先胖 本身 婴儿 肥 初中 九 十多斤 是因为 学校 饭菜 太差 全靠 苹果 撑 饿 14 岁 一米 五五 九十斤 饿 十七岁 一米 五七 一百多 不 数字 踏踏实实 好好 吃饭 长起       展开 全文 c 
 卞卞1995: 再次 上 用光 好运气 感觉 不到 余生 长 撑下去   
 下午我睡觉了: 好久 逛 超话 想 想 度过 那段 时光 好像 撑不下去 怀念 签到 不 好像 生活 那种 热情 过得 好 ？ 感觉 好久 消息 蛮 好 蔡 徐坤   
 羽墨青丝: 感觉 好像 撑不下去   
 橦執: 難自渡 : 撑不下去 只想 奔赴 朋友 怀抱 里 都 说 都 不用说 喝酒 吃火锅 都 治愈 
 盐不甜芝士: 撑不下去 再多撑 一点 背完 早上 结束 每次 都 终点 旁边 死 掉 学期 努力 全都 水中 月 踩 一脚 碎个   
 弋方_: 嗨   真的 好 快 落 刘码 露   : 这才 只播 区区 两天 下周一 二三 加播 两集 好 累 好 快乐 翛 翛   : 害 ！ 我刚 去 突击检查 下 截止 23 点 30 分 投稿 日期 6 月 30 日 陈情 令 视频 854 陈总实 红 
 陳简单100317: 有种 感觉 段 友情 撑不下去 ！ ！ 开 一丝 玩笑 每次 聊天 还 想想 哪句 说 哪句 不 说 ！ ！ 不想 样子 ！ ！ 我累 真的 累 放弃 ！ ！ 祝好 ！ ！ 友情   
 JoJo姣姣吖: mo   mo   这辈子 做 错事 太 活 好 累 真的 撑不下去 发生 意外 想 做俊俊 干妈 照顾 都 去 我家 看 爸妈 此条 信息 长期有效 常用 密码 都 名字 全拼 加 手机 后 四位   
 茕兔HELL_AKANE: 春川宙 0701 生日快乐 ## 春川宙  春川宙 偶像 梦幻 祭  偶像 梦幻 祭宙 く ん と じ 誕 生日 で す ね ( * ワ ｀ * ) 幸運 だ ね ぇ ー お 誕 生日 お め で と う ご ざ い ま す 同一天 生日 真的 太好了   
 LANoyadeGirL: 喜欢 很多 歌手   唯独 只 爱 一个   至亲 最 艰难 段时间 陪 虚拟 人物   来讲   不仅仅 爱豆   更是 撑下去 理由   巧合   欧美男 歌手 分类   A 开头 刚好   每首歌 都 背 滚瓜烂熟   中国 两次 演唱会   中考 高考   都 错过   接近 拼死 学 英语         展开 全文 c 
 深蓝_687: 追 三季   终于 决心   一集   不 打开     一个 镜头   纯 镜头 + 歌曲 + 男主 自白   感觉 更好 些     女主 台词 很尬   本身 演技 真 不怎么样   第一季 第一集 没 好感   刷到 无感   刷 没 好感     故事 撑下去 三季   歌曲 制作 棒棒 
 董董的呀: 真服了   复习 总 吃 撑 坐 不   考完 计算机 吃 撑   来来回回 图书馆 走廊 里 走 一个多 小时 才 走 1.2 Km   立 flag   7 月 不再 吃 撑   
 金子哩: - 梨 李 : 大 哥哥 生日快乐 ！ ！ ！ ！ 
 Mogummy_: 快乐   
 McThea: 蔡 徐坤 Hard   To   Get - 蔡 徐坤 ## 蔡 徐坤 0802 生日快乐   cxk   巨 c 
 哀喜0813: 水深火热 不 捕获 朋友 父母 只言片语 安慰 还 再 往前走 变得 厉害 一点 有人 背后 苦苦 撑   
 犬草田LMNOPQ: 好消息 快 撑不下去   
 我就想叫十六怎么那么难: 赢 造型 赢 : 哈哈哈 太 可爱 莫染 改名 _ : 接下来 一周 更久 看 姐姐 微博 收获 快乐 
 到不了的都叫做远方___: 好 难过 难过 一个 筛子 不 奢望 太 才 会 难过 都 不 撑下去   
 小小的小蔓蔓的蔓蔓: 承认 我过 一点 不好 很多 真的 都 熬 不   快要 崩溃 不 压力 改变 都 太 好多 事情 真的 接受 不了   无力 抗拒 只能 哭 完 再 爬起来 老老实实 走 这辈子 从来 没 坚强 大小 坎 都 死 撑过去   孩子   长 点心   好   
 iyugaaaa: 好 清澈 ！ 林宥 嘉 0701 生日快乐   林宥 嘉 idol 世界 巡回演唱 会 
 1-eleven--1: 想 自由   ( Live ) - 林宥 嘉       拒绝 迎新   心有余力     yoga   生日快乐       下半年 快乐 
 EdwardFun520: 人生 真的 一场 游戏 每名 玩家 开局 抽个 大礼包 人 抽到 金币 人 抽到 999 满级 段位 低 大神 带飞 段位 提高 打怪 难度 随之 增加 升级 之路 人 技术 人 充值 玩家 撑不下去 会 或早或晚 选择 离开 游戏 退出 都 为时尚早 ？       展开 全文 c 
 羽禅台北: 愿 惦念 之人岁 岁 平安 健康长寿 快快乐乐 分享 单曲 K 唯独 不 可取   ( Live ) （ 网易 云 音乐 ）   
 ELLA不是咸鱼: 帅哥 都 生日 ？   生日快乐 
 mmuuup: 朝夕相处 十几天 难过 第一次 带课 带课 肩负着 小可爱 上岸 愿望 才 撑 前程似锦 不 说 只 希望 未来 领导 好好 发光 发热 初心 ~   
 yangqqingssss: 不 撑下去 没   
 nuckingawesalme: Moonystruck : 苏 多尔 鸡 : 北国 佳人 李春姬 : 时代 痕迹 Tiger 公子 : 纯良 英俊 笑了笑 : 太 奇妙 36 年 后 比照 莫名 感动 江南 大 野花 : 纯真 笑脸 快乐 童年 特别 几个 小朋友 长大 后举 当年 照片 感动 月刊 勇者 KuMa 君 : 牛 逼 这才 拍照 意义 所在 留下 故事 青 艸 堂 : 這 篇文章 特 
 蔡長壮: 感觉 一个 深闺 怨妇 见到 不 抱怨 还 不少 相比 人 聊天 更 倾向 怼 人 骂人 想 吐 槽 一天天 上课 课 内容 大于 意义 可过 这阵儿 意义 大于 内容 第二次 重来 那种 感觉 快 撑不下去   
 不专业的奶爸: zxc668   男人 唯唯喏喏 不吭声 妇人 叹 口气 道 放心 一日 夫妻 百日 恩 瘫 瘸 都 抛下 一个 妇人 这家 撑不下去 女人 说 说 呜呜 哭泣 男人 长长地 叹息 一声 道 小东 别哭 对不起 那心 留下 ？   
 lemonlingo: - 累到 瘦 三四斤 到达 近几年 体重 最低点 再 感觉 身体 撑不住 别人 情绪 不 好吃 很多 焦虑 都 不想 吃 感觉 都 抛弃   
 想不到明天的明天: 每次 想 吃 东西 肚子 都 很饱 很撑 真的 饿 反倒 都 吃 不   
 柚子柚子__翼: 记 上 一笔 hold 住 快乐 ！   O 网页 链接   
 Elvira潘朵拉: 从小 有人 告诉 坚强 女孩子 自强 自立 人 告诉 撑不下去 再撑 忙 看病 都 没 时间 人 工作 再 努力 loser   
 公証人: 撑不下去   
 我有一只小喵喵: 人生 艰难 怕 撑不下去   
 浴巾独占: 狙组 人民 好 才华 收获 快乐   
 将定沪一族: 写给 九句 话 撑不下去 [ 泪流满面 ]   
 昊啾啾_: 好像 真的 快 撑不下去     
 Kim_number: 快乐 幸福 回忆 专用 小 马甲 : 想要 快乐     花泽 美美 : 好好 赚钱 ！ 别想 没   M 大王 巡山 : 想要 都 拥有 得不到 都 释怀 苍南 派 : 快乐 工作 快乐 生活 雨 玲玲 zjl : 愿 努力 不负 期望 ali _ thin : 求 减肥 Tiger 公子 : 再 生病 
 blueblueskyyy: 过程 狗血   先 试试看 ! 会 固步 不前 好 ! 这段 关系 里 撑不下去 希望 勇气 走开 希望 成长 过分 伤心 贬低 坚信 值得 爱 一个 可爱 姑娘 希望 过分 依赖       展开 全文 c 
 山阴路房屋中介: 北国 佳人 李春姬 : 时代 痕迹 Tiger 公子 : 纯良 英俊 笑了笑 : 太 奇妙 36 年 后 比照 莫名 感动 江南 大 野花 : 纯真 笑脸 快乐 童年 特别 几个 小朋友 长大 后举 当年 照片 感动 月刊 勇者 KuMa 君 : 牛 逼 这才 拍照 意义 所在 留下 故事 青 艸 堂 : 這 篇文章 特別 採訪 36 年 後 找到 「 小 
 蔡舒蕊: 七月   盛夏 快乐   
 cool小拉: 讲评 试卷 气绝 快到 暑假 撑不下去   
 yue_月上柳梢头: 都 不 掉 面霜 两天 一大 坨 怀疑 撑 不到 结束   
 废话整合中心: 希望 开心 顺利 有个 甜甜的 恋爱 展台 手册 : 开心 一点 夏目家 小 诗哥 : 家人 健康 平安   顺顺利利 苍南 派 : 快乐 工作 快乐 生活 雨 玲玲 zjl : 愿 努力 不负 期望 ali _ thin : 求 减肥 Tiger 公子 : 再 生病 
 障障小宝贝_: 挂水 快好了   荷包 撑不下去   
 妙木山山民:  进击 巨人 第三季 part2 结束 海 真相 、 代价 依旧 血淋淋 残酷 世界 残酷 美好 残酷 永远 都 美好 会 珍惜 美好 ？ 人 不 沉醉于 东西 估计 都 撑不下去 找到 沉醉 东西 ？   
 不要管了啊: 想 轻轻松松 简简单单 快快乐乐 都 难 痛苦 真实 痛苦 是因为 庸人自扰 未雨绸缪 不 搞 丧 真的 好烦 就让 好好 烦 一会儿 都 不行 有病   
 我有一只小喵喵: 人生 艰难 怕 撑不下去   
 多多是doodle: 周六 野 Day93 下半年 第一天   大姨妈   10min 改善 斜方 肌 10min 臀腿 5min 瘦 手臂 30 反式 撑体   几天 再 恢复正常 回想 上半年   105 - 88 - 92   不再 专注 我要 减肥 一件 事   不再 过度 节食   世界 上 完美 身材   试着 学会 接纳 不 完美   努力 追求 更 健康 生活 方式   坚持下去       展开 全文 c 
 TONGJINLING59:   才 更 热爱生活 生活 灰色 都 不 撑下去   
 瑶见夕雪Mini: 生日快乐 ！ ！ ！ 
 痞子·: 生日快乐 家鸽 
 Ewailen: 睡 : 消防员 撕心裂肺 哭声 还 记得 努力 猫 阶级 : 记得 女孩 跳楼 前 消防员 说 谢谢 真的 撑不下去 苦苦 挣扎 那段 黑暗 时光 里 不到 一句 抓 
 正念导师秦乐: 东西 不 快乐   L 正念 导师 秦乐 微博 视频   
 阿戳阿阿阿: 再 吐下去 我怕 撑 不到 张颜齐 21 岁 生日   
 嘟嘟说要做自己:  锦衣 之下 想 忘记 煎熬 还 七月 锦衣 会 ？ 一个 理由 快 撑不下去 O 网页 链接   
 看破红尘200002: 酒精肝 不 能撑 多久 ! 只能 对不起 家人 !   2 绍兴 · 浙江 宝龙 工业园   
 鸭梨大dd: 晚上 去 九 田家 吃 烤肉 撑 不行 回家 后 洗漱 完毕 躺 床上 饿 吃面 不 去 小狗   去   
 江染jiang: 梦想 天 见鬼   求求 阮东廷 快 碰见 我快 撑不下去 
 夕丙搏洁: 哈哈哈 哈哈哈 哈哈哈 哈哈哈 哈哈哈 沙雕 鹦鹉 快乐 源泉 ！     
 妈粉扛把子: 受不了 受不了 就算 俩 男主 都 撑 不下 看 ！ ！ 问 一句 剧版 温情 去 死 ？ ？ ？ ？ ？ 
 譚迟迟: 想 足够 少   快乐 会 追 跑   
 希宇宝宝的小哨子wa: 啊啊啊 啊啊啊 啊啊啊 感觉 撑不下去 李易峰 日子 真的 好 难过   
 不可以吃的包包: 上半年     剩下 半年 曾 很多 快 撑不下去   崩溃 掉 时刻 照样 走 经历 过太多 不 阶段   内心 变强 下半年 目标   先 好好 减脂     工作 先 做   至少 先 茶米 油盐   解决 温饱   
 啾咪苏: 六月份 ......................... 好 不 说 反正 一点 都 不 快乐 水逆 快点 退散 下半年 幸运 点叭     2 漳州   
 蓝水觅深: 小龙虾 冰棍 写给 九句 话 撑 [ 做鬼脸 ] 不   
 想取个名字叫可乐: 撑不下去   
 此身_长安: ／ 感觉 问着 白痴 ／ 感觉 眼睛 哭 瞎 ／ 内心 真的 千疮百孔 — — 依然 做出         信 美丽 样子 去 面对 明天 面试 — — 两         张 不想 脸 — — 彼此彼此 ／ 好 想 都 不想 好好 睡一觉 ／ 撑下去 不 还要 撑 多久 还 撑         多久 想 死 觉着       展开 全文 c 
 NO_Champion: 快 撑不下去 再 逼 一把   
 元气满满小盆友: 大概 马上 会 撑不下去   
 愚童__: 解决不了 事情 应对 不了 ！ 糟糕 2019 年 ～ 本身 一个 无比 悲观 人 负 能量 整体 充斥 命运 生活 还 一次次 捉弄 有时候 都 崩溃 想想 家里 一个 撑下去 ！ 好 累 真的 累 ～   
 耶加唯菲儿: 大概 很多 撑不下去 恨   2 南京   
 单Genius: wow 看 韩剧 啊啊啊   听见 声音 简直 消除 韩剧 偏见 .... 最 讨厌 电视剧 感觉 bbbbb   感觉   妈   绝   太棒了   简直 爱死 李宝英 姐姐  李宝英 李钟 硕 腿   尝试 看 太阳 后裔   第五集 撑不下去 ... 感觉 太 无聊       展开 全文 c 
 要努力考上研究僧的禾: 回归 大三 说 再见   经历 一个月 期末 复习   考试 周   课设 周   熬 两个 星期   通 两次 宵   算是 通 一夜 去 验收 课设   放 几天 假   一个 学期 完完整整 放过 假   不 真的 撑不下去   一个月 真的 折磨 放假 好 快 落 ！ 好       展开 全文 c 
 再熬夜胖十斤: R1SE - 姚琛 :  R1SE                     入住 新 家 快乐 ～     10 年   20 年   30 年 R1SE Family       Together   Forever           
 莫莫莫莫莫奈: 李汶翰   0722 生日快乐   李汶翰 好 火 UNINE _ 李汶翰 
 你看树上有只猪也:   怜爱   想起 小朱 上半年 差不多 状态   真切 列出来 行程 安排表 明白 咳复   一个 感冒 拖 半年   骂 公司 不 做人 红 代价   偶像 不温不火 这一说   抠 脚   刀山火海 千难万难 撑下去 ギ リ ギ リ   
 杯酒xw: 出门 见 姐妹 太 快乐 忘记 照相 染 黑色 都 快 掉 光 发色 （ 晕   
 玖零余生: 人生 旅途 中 很多 时间 都 回忆 中 度过 回忆 痛苦 悲伤 快乐 幸福 更 明白 很多 道理 人生 后悔药 人生 回头路 人生 删除 键   
 李汶翰的小盒妹鸭:  李汶翰 lwh   李汶翰   0722 生日快乐   七月 请 善良 可爱 男孩子 好 一点 李汶翰 走 李汶翰 夏日 情书   lwh   李汶翰 追球   UNINE _ 李汶翰   
 这里是懒懒呀: 就算 生活 不如意   处处 碰壁   请 硬着头皮 撑下去   毕竟 还 强大 人 听听 声音   再 痛苦 请 等待 希望   绝不 打倒   
 unhappygoose: 脚 踩 体制 内 拳打 流量 圈   出国 唱 跑调 海外 无人 晓   出圈 全靠 假唱 逼格全 凭粉 吹   原创 想出 好剧 还 跨界 撑场   借沪圈 雄心豹胆 编不 反正 小鹅 不   
 AT-独乐乐_865: 宋仲基 否认 宋慧乔 出轨  初融 夫妇 祝 生日快乐 关晓彤 917 生日快乐 偷来 祝福   
 lenin-leo: 北国 佳人 李春姬 : 时代 痕迹 Tiger 公子 : 纯良 英俊 笑了笑 : 太 奇妙 36 年 后 比照 莫名 感动 江南 大 野花 : 纯真 笑脸 快乐 童年 特别 几个 小朋友 长大 后举 当年 照片 感动 月刊 勇者 KuMa 君 : 牛 逼 这才 拍照 意义 所在 留下 故事 青 艸 堂 : 這 篇文章 特別 採訪 36 年 後 找到 「 小 
 晴雨剑: 压力 无形中 越来越 紧 本来 撑住 一件 小事 爆发 ！ 心情 不爽 到极点 ！ 刚刚 居然 宿舍 设备 极度 匮乏 情况 下 马桶 整通 好像 事 都 豁然开朗 ！ 难受 过不去 坎 马上 就要 成功 前 障碍 期待 事 努力下去 肯定 会 好 ！       展开 全文 c 
 小骄傲的专属FD: 感觉 得不到 安全感 真的 累 好 累 打起精神 面对现实 面对 真的 撑不下去 不 ？ 有时候 冥想 到底 活下去 ？ 来到 世界 上 使命 ？ 累 就要 永远 休息 家人 朋友   
 晓玲200509: 六月 太阳 很烈 空气 中 飘过 一阵一阵 夹杂着 汗臭味 热风 晓月 傻傻的 站 学校 操场上 太阳 火炉 炙烤 脸上 滚落 不 汗水 泪水 神情恍惚 快 撑不下去 倔强 不   2 广州   
 打野的高哈哈: 看上去 都 很 快乐   
 我堕入情网你却在大排档: 每次 撑 不   撑   会   好像 没什么 不 Dream   It   Possible - Delacey   
 仙女觉得人间太险恶: 喝 三杯 咖啡 一罐 红牛 我要 撑不下去   
 怪也欤: 真的 很 好   真的 快乐 幸福   
 疯叶兔兔啪嗒啪嗒地唱歌歌中: 都 思考 还 两个 人 喜欢 再 一点 一个 人 身体 里 涌现出 之多 喜欢 现实 好 喜欢 两个 感觉 浪漫 快乐 喜欢 cp 喜欢 两个 人 感觉 一种 宁静 幸福 （ ？ ）   
 用户6889004658: 撑不下去 会 有时候 撑 不撑 住 心态 放好 对手 特别 希望 死 希望 疯 何必 上当 说 胳膊扭不过大腿 水能载舟 覆州 蝼蚁 苟且偷生 力量 再 悬殊 不战而败 只 剩下 一个 人 不 做 逃兵 清白 受害者 何惧 栽赃 迫害 事       展开 全文 c 
 攒钱为岳岳买球队: 岳岳 PINKRAY 应援 联盟 : 喜迎 7 月 生日快乐 月 ！ 转发 本条 微博 关注 岳岳 PINKRAY 应援 联盟   7.11 当天 抽 一位 姑娘 送 本次 活动 全套 周边 （ 3 套 set ） 微博 抽奖 平台   
 宗七月: 小羊 爱 吃 酱 肘子 : 想要 爱 朋友 都 好好 ！ 回忆 专用 小 马甲 : 想要 快乐     花泽 美美 : 好好 赚钱 ！ 别想 没   M 大王 巡山 : 想要 都 拥有 得不到 都 释怀 苍南 派 : 快乐 工作 快乐 生活 ali _ thin : 求 减肥 Tiger 公子 : 再 生病 
 Hetun本豚: 生日快乐 ！ ！ 都 好 ！ ！ 很快 见面 ！ ！ 
 菇荚染狼娇钨那部huan: 总 父母 说 一句 爱 都 说不出口 不 害羞 不说 都 主动 说 后 发现 笑容 更 甜 就算 说 没得 母亲节 快乐 妈妈 祝愿 天底下 母亲 节日快乐 ！   
 onedaylme: ioi 重组 官宣 wtmxsl 人 真的 太 搞笑   请 夏 都 撑起 solo   都 做出 成绩 才 真的 重情 重义 好   国内 蹚 浑水 混不下去 败 名声   真的 占 大 便宜 好   居然 有人 说 话   真的 生气   便宜 还 卖乖   
 追风少女森绘梨佳: 听说 上午 偷吃 猫 粮 撑 午饭 都 吃 不 ？ ？ ？ （ 肚子 撑 ）   
 OlivierFlament: 今晚 大内 不用 蹲 邀请 码 7 月 1 废文网 大内 总管 : 近期 管理 组 类似 升级 无 意义 水贴 1106 条 点评 593 条 两次 外来 粉圈 引战 数十起 不看 版规 、 格式 错误 提问 多个 莫名 敏感 话题 边限 标记 违规 图示 （ 见 评论 ） 恶性 谩骂 真的 撑不下去 再 放开 
 陳简单100317: 有种 感觉 段 友情 撑不下去 ！ ！ 开 一丝 玩笑 每次 聊天 还 想想 哪句 说 哪句 不 说 ！ ！ 不想 样子 ！ ！ 我累 真的 累 放弃 ！ ！ 祝好 ！ ！ 友情   
 忘鸟爱: 濒临 崩溃 边缘 快要 不 撑下去   
 我想发财暴瘦: 大半夜 买 几袋 螺蛳 粉 试试看 好不好 吃 减肥 人 快乐 简单   
 秋名山车神刚就易阵风: 做 完 英语 窝 桌上 快要 撑不下去 圆圆 圆肚肚 : 下课 添 福宝 伪 阿姨 助攻 组 : 500 早上好 困 
 leotanything: 动漫 节操 君 : 国漫 频道 : 7.1 生快   微笑 日 推 _ 日常 : 生快 ！ 永远 爱 最 温柔 善良 走过 二次元 : 夏目 小天使 生快   永远 爱 掉 一只 龙猫 :   生日快乐 呐滋 咩 愿 七月 美好 
 我说是就是259695: 撑不下去 拉拉   
 黔驴c: 看 眼微博 几个 博主 激情 发言 开心 睡觉   ( 刷 skk 微博 带来 快乐 超过 lof     
 大胖的辣椒: 生日快乐 
 长白池鱼爱听曲儿: 潘子 ！ 生日快乐 别忘了   
 将定沪一族: 写给 九句 话 撑不下去 [ 泪流满面 ]   
 四三拍: 可爱 一夏   新 工作 目标 才能 撑下去 ！ 再来 立个 flag 老气横秋 爱 稳 静 滴 做 事情 干嘛   不 都 开心   将来 开心   
 舞狮队二妹上树冥想记: 生日快乐 小绒 ！ ！ 
 杨小扬儿: 第一天   熬 发现 真的 撑不下去   
 南风未起XC: 实习 培训 第一天 听 很 绝望 不 九个 月 撑得住 都 很 想 说 去 看 一忙 没 时间 没什么 事 捯 饬 很 晚 再次 一个 陌生 环境 一周 总共 吃 六 顿饭 不饿 吃 不 减肥 瓢瓢 记得 按时 吃饭 睡觉       展开 全文 c 
 叶幸运和叶小宝的故事: 换个 乐器 多事 接下来 多集 想想 片头 片尾曲 场景 撑下去 说 不 看 时 真香 他俩   锁住 毕竟 演员 拍 很 辛苦 
 用户1401677482: 世界 上 最 快乐 事 莫过于 梦想 奋斗 — — 苏格拉底   
 用户1404799263: " 钱 很 帮 很多 人生 梦想 人生 快乐 钱 太多 关系 希望 人 都 快乐 赚钱 呀呼嘿哈哈啦哦: 永远 懒洋洋 自由 向往 自由 勤奋 努力实现 更 广阔 人生 下半年 撑不下去 记得 这句 话   
 胖脸m崽: 找到 合适 满意 工作   健康 生活 回忆 专用 小 马甲 : 想要 快乐     花泽 美美 : 好好 赚钱 ！ 别想 没   M 大王 巡山 : 想要 都 拥有 得不到 都 释怀 苍南 派 : 快乐 工作 快乐 生活 雨 玲玲 zjl : 愿 努力 不负 期望 ali _ thin : 求 减肥 Tiger 公子 : 再 生病 
 __子昆: 真的 懒得 纠结 一口 薯片 卡路里 反正 姥子 长 样子 胖点 瘦点 都 没 影响 一张 胖脸 先胖 本身 婴儿 肥 初中 九 十多斤 是因为 学校 饭菜 太差 全靠 苹果 撑 饿 14 岁 一米 五五 九十斤 饿 十七岁 一米 五七 一百多 不 数字 踏踏实实 好好 吃饭 长起       展开 全文 c 
 七七吃饱才是真的快乐: 撑不下去   
 我姓李却不能li你: 此时此刻 心情 难以 言语 表达 不 关系 多久 真的 爱 不 上 表现 ？ 对不起 真的 看不出来 爱 都 说 孩子 撑 下 有时候 真的 撑不下去 不 欠 一个 男人 不 承受 应有 担当 ？ 事 都 老婆 计较 唯一 一点 证明 人       展开 全文 c 
 用户5615984248: 希望 平庸 平淡 快乐 痛苦 都 爱 人 拥抱 不仅仅 矫情 奢望 足球 分享 单曲 多想 平庸 生活 拥抱 （ 网易 云 音乐 ）   
 张啊啊啊啊艺: 55 分钟 撑不下去 睡觉 第十四 年 酒肉朋友 狐朋狗友 塑料 姐妹 XLiHNNiu   祝 开心   
 酱子吖516: 这部 剧 场景 切换 剪辑 真的 很大 ！ 港真 路 人 真的 看不下去 撑 真的 看忘羡 一博 打戏   
 其实我超A的: 半夜 醒来 想到 yoga 生日 真的 说不出 特别 祝福 话语 一个 都 家人 努力 生活 人 带来 勇气 家鸽 一个 不缺 祝福 人 还 说 — — 谢谢 真的 谢谢 希望 快乐 健康 希望 生活 里 idol 
 猥琐叔叔锕: 撑下去 回忆 专用 小 马甲 : 好滴 朋友 奇葩 : 好 ！ 张奶霞 : 祝福 ！ 锦鲤 蛋 : 一条 都 开心 ！ 糗 事 bot : 不 希望 渣 蜀黍 : 加油 ！ 没 : 核仁 布朗 尼 : ！ 夏正正 :   都 刚刚 好 黄濑濑濑濑 : 都 一帆风顺 
 杨漂漂TT: 承认 我过 一点 不好 很多 真的 都 熬 不   快要 崩溃 不 压力 改变 都 太 好多 事情 真的 接受 不了   无力 抗拒 只能 哭 完 再 爬起来 老老实实 走 这辈子 从来 没 坚强 大小 坎 都 死 撑过去     2 兰州   
 俆_dan: 集市 上 鱼   水分 蒸发 差不多   时常 就要 撑不下去   前途 未卜 痛苦 里 周而复始   死   偏 不肯 温柔 豢养   
 董熙予: 新 （ 月 ） 竟 不知不觉 五 十多分钟 人生 不知不觉 好比 生日 竟 已 一个月 珍惜 生命 家人 快乐 不知不觉 - -   
 昊啾啾_: 好像 真的 快 撑不下去     
 樂活的女人: zxc668   男人 唯唯喏喏 不吭声 妇人 叹 口气 道 放心 一日 夫妻 百日 恩 瘫 瘸 都 抛下 一个 妇人 这家 撑不下去 女人 说 说 呜呜 哭泣 男人 长长地 叹息 一声 道 小东 别哭 对不起 那心 留下 ？   
 一直都要哈哈哈: 柳暗花明 才 我快 撑不下去 ！ ！ ！   
 看到最远的天空: 很 特别 日子 一周 ; 一个月 开头 ; 下半年 第一天   祝 :   周一 快乐     月初 开心   年 中 如意 !               感   恩有                   晚安   
 我是一个小号xxx: 绘画 快乐 痛苦 失恋 充满 感受 心情   
 沙雕小兄弟: 感觉 快 撑不下去 灰心 更 糟心 事儿   
 幸福的宋小爽: 毕业 快乐     2 上海 · 上海大学   
 昆明Hers半永久培训-yoyo: 一个 创业者 都 故事 年 感觉 快要 撑不下去 时刻 回过头来 看 都 珍贵 礼物 抱怨 畏惧 未来 女人 经营 好 取悦 更 vx15924880008             — — HERS 半 永久 培训   
 令舞轼: 关注 大熊猫 奇一奇果 生日快乐 超话 小伙伴 快 大熊猫 奇一奇果 生日快乐 超话 聊聊吧 ~ 戳 →   http : t cn EoJm5JR   
 S九尾妖狐: 摊上 婆子 倒 八辈子 霉 ！ 不 想带 孩子 离开 感觉 撑 很 累 ！   
 奶油五香炒瓜子: 新 一周 朱一龙 才能 撑下去 没关系 不 OK 旧图 够 看   
 macroqz_517: 再见 ！ 陪伴 三年 种植园 日前 浣 东 双桥 中心 幼儿园 大班 孩子 毕业 离开 大 班 孩子 带 小班 弟妹 来到 种植园 介绍 种植园 里长 高 向日葵 、 即将 成熟 玉米 、 毛豆 分享 种植园 惊喜 快乐 希望 小班 弟妹们 打理 好 种植园 从中 体验 劳动 收获 快乐 （ 周建儿 ）       展开 全文 c 
 屋顶羽毛: 生日快乐 
 永湖南北: 李泰容 0701 生日快乐     先   还 备考 考完 再 一点一点 看 
 顽主儿-: 憨豆   麻烦 再   天 真的 撑不下去 陪   
 元里元里: 生命 看 多重 快乐   2 上海   
 Aimeego: 身体 耐心 都 快 临界点 撑不下去   
 叫我谢敏好了: 白天 玩 黑夜 ~ 放纵 一个 快乐 细胞 有趣 人 从来不 会 累 更会 雀跃 明天 说声 期待 上半年 做过 后悔 事多到 不值一提 没关系 反正 未来 一团 迷雾 无路 可退 当下 都 先 纵情 尽兴     
 五月青枫: 93 级 ！ 不 62 级 高资   还 撑下去 
 開始結束你不懂: 生日快乐 男孩     治愈 系 - 夏目 友人 帐 : 生日快乐 ！ 
 揉脸脸: ACE 生日快乐 永远 爱 
 泰味蜜萝柚: 李泰容 0701 生日快乐   无糖 新文化 : 李泰容 0701 生日快乐 碳酸 洗發水 : 李泰容 0701 生日快乐   Sorceress 小樱 : 李泰容 0701 生日快乐   1995 · 07 · 01 : 转发 此条 微博 带 李泰容 0701 生日快乐   抽俩 每人 71 元 再 抽 1 人送 小 蛋糕 200 元 以内 选择 
 Curly-Fool:  名 侦探 柯南 每次 刷到 这集 心疼 死 真的 看不下去 柯南 重 感冒   难受 还 强撑 推理 会 照顾 ！ 小兰 不 关心 好 想 抱 沉重 身体 不用 站 难受 晕倒       展开 全文 c 
 Osh-eng香: 宣酒 6 上市 热销 一周年   一周年 快乐 ！ 低小 明儿 韩家 仔 自心 自虐 
 zheeeewen: 哈哈哈哈 哈哈哈哈   zyl 一个 讲 相声   还 没 粉丝 搞笑 猕猴桃 好 可爱 水果 _ : 哈哈哈 哈哈哈 哈哈哈 哈哈哈 哈哈哈 哈哈哈 哈哈哈 今日 快乐 源泉 暑假 没事干 学习 毕竟 努力 小学 四年级 肄业 姜熙 健 男朋友 : 建议 第一步 去 精神病院 妄想症 治 好 
 徐家迷妹子-: 肯定 穿着 不合 脚 鞋子 苦 撑下去 早上 毅然决然 回家 换 双鞋 七月 苦尽甜来   
 一朝一暮是茶欢: 2019 年 一半 上半年 结束 时间 过得 很快 小卢 同学 快 半年 有时候 很久 有时候 没多久 期间 发生 大大小小 很多 事情 吵吵闹闹 很 有时候 实在 过不下去 才 几个 小时 想 想到 不行 晚上 都 撑 不 脾气 很 爆       展开 全文 c 
 向日葵园里的猫看着的彼岸花儿: 吴昕 潘玮柏 香港 热 搜 无尾熊 去 香港 度假 ！ 说 谢娜 孕后 首 亮相 设计 品牌 活动 身为 快乐 家族 吴昕 怎么着 支持 ！ 好像 吴昕 嘉爷 Lwill _ orfila 秒 拍 视频   
 蔡長壮: 感觉 一个 深闺 怨妇 见到 不 抱怨 还 不少 相比 人 聊天 更 倾向 怼 人 骂人 想 吐 槽 一天天 上课 课 内容 大于 意义 可过 这阵儿 意义 大于 内容 第二次 重来 那种 感觉 快 撑不下去   
 Oosakiren: 想要 快乐   想要 喜欢 人 谢谢   回忆 专用 小 马甲 : 想要 快乐     花泽 美美 : 好好 赚钱 ！ 别想 没   M 大王 巡山 : 想要 都 拥有 得不到 都 释怀 苍南 派 : 快乐 工作 快乐 生活 雨 玲玲 zjl : 愿 努力 不负 期望 ali _ thin : 求 减肥 Tiger 公子 : 再 生病 
 翻茄her: 李泰容 0701 生日快乐 李泰容 _ TaeYongBar : 转发 容 微博 带上 李泰容 0701 生日快乐 tag 当原 微博 转发 7100 时 主 八八 将会 抽奖 送 金 701 * 1 、 521 * 1 、 171 * 1 、 2 条泰容 生日 官方 手链 、 3 份美 巡泰容 相关 官方 展会 周边 、 2 份 coex 官方 泰容 周边 明晚 开奖 为泰容 鸭 
 可耐的顾先生: 刚刚 EXO 视频 眼泪汪汪 愿望 去 见 EXO 看 完 视频   愿望 希望 EXO 哭 希望 EXO EXO – L 永远 希望 EXO 幸福快乐 健康 都 不 比起 哭 包世勋 wu 世勋 - EXO   更 喜欢 眼睛 笑成       展开 全文 c 
 想变幸运的女孩kk: 坤音 一点 危机意识 都 青营 一播 走 一批 粉丝 cql 一播 肯定 还要 走 身边 都 鲜活 例子 拜托 好好 营业 新粉 吸 不了 老粉 还 走 一大堆 还 撑下去 看不到 未来 最 失望 一点 不 还 多久   
 HXNEX:  李泰容 小容 生日快乐 ！ 承诺 说 永远 喜欢 喜欢 时 我会 付出 真心   
 只只曉彭: 刚刚 好 搬 砖 一个月   我爸 每次 发 视频 都 会 问 有没有 钱   没钱 说   每次 都 死 鸭子 嘴硬 说 上次 还 说 不好意思 都 养 多年 大 不在乎 一下子 感动 实在 撑不下去     说 没 钱   我爸 给我发 两百   结束 没想到 隔 一小 会 连发 两个   我以       展开 全文 c 
 大白兔小先森: 有时候 真的 不想 撑下去 想到 在家 平安 回来 会 想 办法 坚持下去   
 嗨我来抓人了: 老公 安宰贤 0701   生日快乐   
 泉州师范学院表白君:     君 想 一个 人 卑微 尘埃 里 却 无法挽回 对方 放手 ？ 撑不下去 求解         
 如果有理由: 七一 建党 节 快乐       
 ni的甜心: 太热 太 热 胖崽要 撑不下去     
 枪都给你别打我: 连续 两周 三点 半前 没 睡 过觉   五点 睡 八点     传媒 不 睡眠 ？ ？ 昨晚 一分钟 无觉 终于 告一段落   再 再 年轻力壮 撑不住 ..   
 jxKLX-挂号信otm: 人 快乐 生活 选择 选择 叹息 ！   
 用户5508185737: 心情 超级 差 别人 轻易 事 ？ 却 努力 2 年 都 不行 身体 每况愈下 生病 才 健康 多么 宝贝 找 真的 好 累 快 撑不下去   2 成都   
 Klery007: 很多 人 不 刻意 见面   真的 见 不到 表面   放在 心底 喜欢 条路 走 很 不   撑不下去 想 尝鲜 想 缓解 却 无济于事 误解   感情 抹 去 埋心 苦笑 最 孤独 时光 塑造 对方 心上 有人 大可不必       展开 全文 c 
 欧阳影双: 罗云熙 Leo     O 网页 链接 上 加油 今生 唯一 执著  罗云熙   棒棒 哒 ！ 快来 TA 应援 !   L 慢游 全世界 酷燃 视频   
 秋名山车神刚就易阵风: 做 完 英语 窝 桌上 快要 撑不下去 圆圆 圆肚肚 : 下课 添 福宝 伪 阿姨 助攻 组 : 500 早上好 困 
 行者禚宝磊: 数据 陈柯宇   送 一碗 长寿面 祝 生日快乐 ！   查看 动图 
 用户6889004658: 撑不下去 会 有时候 撑 不撑 住 心态 放好 对手 特别 希望 死 希望 疯 何必 上当 说 胳膊扭不过大腿 水能载舟 覆州 蝼蚁 苟且偷生 力量 再 悬殊 不战而败 只 剩下 一个 人 不 做 逃兵 清白 受害者 何惧 栽赃 迫害 事       展开 全文 c 
 咖啡爱上猫-corrine: 真的 好 累   儿子 撑下去 世界 五年 前 妈妈 感觉 活 大学毕业     十年   很多 爱 人 爱 人 想 力量 慢慢 去 保护 、 去 爱 到头来 发现 都 保护 不了 不了 别人 太多 爱 失败 输 很惨 可怜 还会       展开 全文 c 
 卞卞1995: 再次 上 用光 好运气 感觉 不到 余生 长 撑下去   
 西蒙Sanji: 大白兔 奶糖 奶茶 人 好多 快乐 柠檬 合作 倒 没 想 喝   
 JoJo姣姣吖: mo   mo   这辈子 做 错事 太 活 好 累 真的 撑不下去 发生 意外 想 做俊俊 干妈 照顾 都 去 我家 看 爸妈 此条 信息 长期有效 常用 密码 都 名字 全拼 加 手机 后 四位   
 清醒0v0: 本颜狗 撑不下去   跑 路 边缘 徘徊 定妆 照给 打击 太大   
 Ewailen: 睡 : 消防员 撕心裂肺 哭声 还 记得 努力 猫 阶级 : 记得 女孩 跳楼 前 消防员 说 谢谢 真的 撑不下去 苦苦 挣扎 那段 黑暗 时光 里 不到 一句 抓 
 丶恰似伱惪温柔娅_: 宣酒 6 上市 热销 一周年   祝小宣宣 生日快乐 ！ 冰蝶 若雅 na __ 忘 听的歌 已 不再 
 elf_yy:  利特   happy   leeteuk   day   生日 快樂 世上 隊長     
 ·婉儿·:     会 幸福快乐 生活 大 山里 
 ·春沐樱花浦·: 生日快乐 
 暴躁网友佐佐木: 同理 学生 撑不下去 选择 休学 休学 未来 反而 明朗 亀 梨 穿 毛衣 等于 杀人 : 转发 微博 
 傲霜雪2010: 西城 SQL : 雾 霾 中服 雾 连个 撑 雨伞 人 都 木有 老婆 不 跑 去 美帝 一天天 烂 tinyfool :   穷国 无 外交 cct98912 :   俄羅斯 老板娘 : 美帝 日薄西山 雇不起 佣人 ！ 雾 霾 中 呼吸 : 撑 雨伞 人 都 木有 瞧不起 
 云吞汐: 水 森林 真的 看不下去 开场 半小时 后 一次次 看 表 感到 头大 想要 离场 硬撑 看 完 矛盾 转折 高潮 在我看来 戏剧 色彩 听 演后 谈 反而 感觉 演后 谈比剧 更 价值   看剧 多年 第一次 理论知识 撑 不起 荒诞派 台词 表现 哲理性       展开 全文 c 
 青春冰丝倩儿: 凡凡   快乐   
 梦小盈盈: 想不到 吃 一盘 半 龙虾 吃 喝 好多 鸡汤 还 吃 三个 水饺 两块 蛋糕 吃 西瓜   超甜 超多水 饭局 九点半 结束   还 撑 躺 不 吃 付出代价   2 淄博   
 努力努力再努力的歪小伦:   感觉 撑不下去   
 PrettyJane: 生日快乐 ！   
 我不熬夜了Z:  张 洢 豪   张 洢 豪 0701 生日快乐   刚好 3 ⑦ ① 天 完美 数字 祝 0701 生日快乐 张 洢 豪   张 洢 豪   张 洢 豪   
 Ngah7: 朴正洙 0701 生日快乐 Sj - special1004   Happy   birthday   teuk   oppa             O 网页 链接   
 想换的名儿都被占了: 谈恋爱 意义 或许 不 排遣 寂寞 、 享受 浪漫 单纯 更 搭建 一个 巢 淋 雨 飞回来 卸下 盔甲 歇歇脚 ；   撑不下去 崩溃 大哭 ； 生活 苛待 治愈 人 想要 充满希望 活下去   
 Typewriter猴_VoV: merry   xmas 杏 银杏 : 圣诞快乐 完事 文乃廚 : 先 圣诞快乐 苍旻白轮 p : 不 说 圣诞快乐 
 晓TTT彤: 还 不 睡 感觉 胸闷 心慌 大概 后遗症 叭 精神 都 强撑 ？ ？ ？ ？ 感觉 干不动 好多好多 次 还 想 干 真的 瑞思拜 瑞思拜 冷静 再 干 没准 猝死   
 可爱最好磕了: 看晕 夏尔花 千树 : 妈 阿令 开播   说好 产粮 江南 大 野花 : 笑 死     产粮 大户 刘码 露 : 这才 只播 区区 两天 下周一 二三 加播 两集 好 累 好 快乐 翛 翛 : 害 ！ 我刚 去 突击检查 下 截止 23 点 30 分 投稿 日期 6 月 30 日 陈情 令 视频 854 陈总实 红 
 miyastuki: 极少 勇气 少 发现 长久 挣扎 鼓起勇气 做 某事 时 事后 感到 自由 快乐   
 iYooYi小千春: 王晨艺 孤影 游戏 直播 等待 下课 等待 放学 等待 童年 童年 歌谣 依旧 长大 何不 抛 下 生活 重负 重温 儿时 快乐   
 杜子_: 江南 大 野花 :   纯真 笑脸 快乐 童年 特别 几个 小朋友 长大 后举 当年 照片 感动 月刊 勇者 KuMa 君 : 牛 逼 这才 拍照 意义 所在 留下 故事 桂木顺 九 : 几十年 前 胶片 机 拍照 效果 真好 青 艸 堂 : 這 篇文章 特別 採訪 36 年 後 找到 「 小朋友 們 」 感謝 每日 人物 用心 ！ 
 嚲雨5935580937:  林妙 一刻 ## 林妙 0701 生日快乐   朋友 我們 最 善良 、 最可愛的 女孩 林妙   20 歲 生日   祝福 ！ 祝願 新 一歲 開開 心心 快快 樂樂 ！   
 我怎么这么爱狗血: 第九集 第十集 好 难看 ！ ！ ！ 配角 好尬 好尬 陈情 令   连续 发了 两个 微博来 吐 槽 撑不下去   2 苏州   
 终南山古墓派小龙女-: 希望 努力   生活 规律   健康 快乐 回忆 专用 小 马甲 : 想要 快乐     花泽 美美 : 好好 赚钱 ！ 别想 没   M 大王 巡山 : 想要 都 拥有 得不到 都 释怀 苍南 派 : 快乐 工作 快乐 生活 雨 玲玲 zjl : 愿 努力 不负 期望 ali _ thin : 求 减肥 Tiger 公子 : 再 生病 
 别說wanan: 这才 理想 恋爱 水到渠成 话题 顺其自然 走向 恰到好处 陪伴 自然而然 情话       喜欢 东西 会 想着 买 有趣 事会 想着 分享 想 不分场合 随时 打电话 困 告诉 想 睡 不用 撑 陪 日渐 相处 过程 中 喜好 性格 包容 改善 对方       展开 全文 c 
 想变幸运的女孩kk: 坤音 一点 危机意识 都 青营 一播 走 一批 粉丝 cql 一播 肯定 还要 走 身边 都 鲜活 例子 拜托 好好 营业 新粉 吸 不了 老粉 还 走 一大堆 还 撑下去 看不到 未来 最 失望 一点 不 还 多久   
 逍遥小猫酱: 昨晚 篇文章 单位 团购 蛋糕店 撤店 南京 最 热闹 中心 俗称 暴利行业 蛋糕店 做 不 想起 团购 时 问及 店长 上 一个 蛋糕店 为啥 撤走 说 生意 难 做 说 估计 撑 多久 说 十年 没 两年 跑 原因 依旧 生意 难 做 ！ 房租 付不起 ！   
 吉韵生活: 说 金牛 花心 人 金牛 爱过 人 ； 说 金牛 狠心 人 见过 金牛 伤心 人 ； 说 金牛 幼稚 人 金牛 相处 人 ； 说 金牛 小气 人 金牛 朋友 人 真的 走进 金牛 内心 人 才能 体会 金牛 痛苦 忧伤 快乐 幸福 亚蒙 AM30H9 大功率 电磁炉 智能 投影 显示 爆炒 3400W 新 设计 镇 店主 推   
 用户qgcemej6cy: 陈小春 智斗 郝劭文   终于 等到 还好 没 放弃   陈小春 智斗 郝劭文 真的 会 感觉 舒服 快乐 ！   身边 好多 同事 都 讨论 陈小春 智斗 郝劭文 感觉 还 不错   早就 等不及 想 观看 彪壮 看 简介 很 带感 ！   明天 带 老婆 去 看 [ 转发 ]   
 可乐炸鸡来七份: 快 半年 上半年 不 快乐 快乐 做 想 做 事 比如说 打耳骨 钉 、 旅游 、 学 滑板 、 学做 想 吃 菜 答应 手 帐 断断续续 做 答应 要学 韩语 自考 一点一点 地在学 上半年 状态 去年 还要 差 哈哈哈 都 不 调节 希望 下半年 睡       展开 全文 c 
 虎皮猫大人是只聪明的鸟: 爱 发电 老 母亲 江南 大 野花 : 笑 死     产粮 大户 刘码 露 : 这才 只播 区区 两天 下周一 二三 加播 两集 好 累 好 快乐 翛 翛 : 害 ！ 我刚 去 突击检查 下 截止 23 点 30 分 投稿 日期 6 月 30 日 陈情 令 视频 854 陈总实 红 
 一个非常隐秘的大号: 撑不下去 请 回头 父母 请 很 爱 请 撑住 请 开心 请 开心   
 LLhh呀: 明天 好像 快乐 咯   
 莳桉啊: 水 没 脚踝 大厦 门 檐下 堵 好多 人 一个 中年男人 撑伞 走 一个 姑娘 跟前 伞 递给 说 背 一会儿 开门 还 打着 伞 别淋 很 自然 蹲下去 背 孩子 趟 进雨中 吸引 目光 爸爸 穿 皮鞋 笑 得宠 溺 姑娘 快 爸爸 高 穿着 凉鞋 还 不 懂 幸福   
 Dl8whyy: 不想 再 拥有 墙头 想要 平常 持续 追星 不 想要 社交 有时候 人 说话 面孔 太多 不 撑下去 原以为 父母 身边 父母 中 top 前五 很 开明 那种 父母 被迫 发现 免不了 俗套 质疑 很 害怕 坏 情绪 自我 厌恶 缠 上身 做 一个 很 勇敢       展开 全文 c 
 一只可爱粽: 2019 上半年 完 喔 七月 快乐   
 阿步的每一步: 恐怖 妻子 我能 说 部脑 残剧 ？ ！ 瞎编 乱造 反转 反转 鬼扯 简直 侮辱 观众 欣赏 水准 幼稚 人 想起 奥特曼 高分 骗 进去 看 5 集 实在 撑不下去 评论 区 却 真的 由衷 赞美 差三呼 万岁 难道 雨 女无瓜 梗 不 好笑 00 后 代沟 ？   看 美剧       展开 全文 c 
 陈陈墨一: 陈情 令 肖战 王一博 颜值 这撑 真的 看不下去 剧情 也尬 演员 也尬 尴尬 死   
 奶盖敲好喝: 段奕宏 全球 粉丝 汇 :  演员 段奕宏   大秦 帝国 天下   段奕宏 饰演 吕不韦 祝 端午节 快乐 ！ 
 幸福小四毛: 弟弟 实在 太 懂事 同学 去 上海 找 工作 碰到 中介 骗 400 块钱 钱交 工作 没想到 一进 宿舍 傻眼 墙 黑 吓人 返潮 10 几个 人 打着 地铺 只能 找 工作 跑 上海 无数个 区 选择 去 芜湖 实在 没钱 撑不下去 爸爸妈妈 说 还       展开 全文 c 
 啦啦啦咦1: 内涵   实力   追求 标签     快乐     传递 正 能量     愿 永远 年轻   永远 热泪盈眶     翟潇闻会 大 明星   企鹅 集体 相迎       R1SE - 翟潇闻 
 huangchangping汤光翠: 蔡 徐坤坤 坤 新年快乐 新 一年 笑   
 兔子窝yy: 每次 期末考试 都 肥 一圈   还 假期 减肥   历年来 看 大错特错   做 只 快乐 肥宅   暂时   美食 都 不感兴趣   自然 会 瘦 晚安   一点 都 不 慌   
 小文的一生: 7 月 1 不到 六点 起床 早上 收拾 好 站 会 碗 吃完饭 收拾 屋子 很多 不必要 做 事 还好 早饭 合胃口 鸡蛋 咸菜 玉米 一上午 站   走   跑 干 干过 事 午饭 本来 想着 吃不下 一吃开 好像 吃 最 躺 撑 还 量 刚 合适       展开 全文 c 
 I局外人U: 期待 一个 好消息 降临   这潭 不 知名 苦水 中捞   无论是 一个 突如其来   一个 盼念   会 东西 带来 快乐   坚守 希望   日复一日 蹉跎 — —   
 梦瑶小可爱-3-:   啥时候 娶 结束 异地 恋有 好 几次 都 撑不下去 看 哭   L 梦瑶 小可爱 - 3 - 微博 视频   
 伱算阿貓还阿豿: 不忘 初心 九句 话 撑不下去   
 原味高MVP: 大学 刚 毕业 生存 酒店 前台 干着 三个 月 晚上 没 睡觉 上班 白天 睡觉 晚上 上班 感觉 快 撑不下去 专业 相关 工作 却 找 不到 非专业 相关 找不着 很 迷茫 不 再 还 撑 多久   2 长沙   ·   南 门口   
 NEVERfeelTHEsame: 感觉 妹子 本来 小甜甜 微博 表达 爱意 夸夸 月辉 人 看着 心情 愉悦 经历 事 变得 敏感 沮丧 表达 慢慢 转为 担忧 不平 坏 情绪 的确 发泄 感到 一点 可惜 伤害 会 留下 疤痕 细想 月辉 真的 变 带给 粉丝 心动 感觉 快乐 感觉 夸夸       展开 全文 c 
 记自己F: 我快 撑不下去 插 心上 几把 刀子 至今 都 拔出来 每每 触碰 痛不欲生   
 ·望月夏芽·: 生日快乐 
 NGYINGYAN: 善良 任何人 回忆 专用 小 马甲 : 想要 快乐     花泽 美美 : 好好 赚钱 ！ 别想 没   M 大王 巡山 : 想要 都 拥有 得不到 都 释怀 苍南 派 : 快乐 工作 快乐 生活 雨 玲玲 zjl : 愿 努力 不负 期望 ali _ thin : 求 减肥 Tiger 公子 : 再 生病 
 摩羯JEAN就是我: 小 角落 简直 冬天 冷死 夏天 热死 好友 说 全靠 一口 仙气 提 妈呀 真的 太 考验 意志力 热 没 形象 形象 ？ 不 加油 夏天 才刚 撑下去 ！   
 老李老Le: 电视剧 演员 资讯 易 烊 千玺 辣条 快乐 大本营 宣传 小 能手 易 烊 千玺 还 上 最爱大辣条 好 接地 气 ！ L 快乐 大本营 9e2m7 秒 拍 视频   
 马克吐温Mark: 一切顺利 ！ 回忆 专用 小 马甲 : 想要 快乐     花泽 美美 : 好好 赚钱 ！ 别想 没   M 大王 巡山 : 想要 都 拥有 得不到 都 释怀 苍南 派 : 快乐 工作 快乐 生活 雨 玲玲 zjl : 愿 努力 不负 期望 ali _ thin : 求 减肥 Tiger 公子 : 再 生病 
 黑花肥会发挥: 快乐 喷泉 投票 ~ 才 快乐 泉眼 ？ 快乐 喷泉 
 来自二十年之后:  翟潇闻   zxw   翟潇闻 元气 爱豆   内涵   实力   追求 标签     快乐     传递 正 能量     愿 永远 年轻   永远 热泪盈眶     翟潇闻会 大 明星   企鹅 集体 相迎     R1SE - 翟潇闻   
 花花丸子头: 轻松 筹 爱心 接力 ！ - 才 11 岁 爸爸 撑下去 ！   -   轻松 筹   轻松 筹   爱心 人士 你们好 感谢 打开 求助信 袁子翔 11 岁 爸爸 58 岁 爸爸 总和 别人 说 儿子 缘分 浅 ...   O 网页 链接   
 用户6417399873: 何洛洛 绝不 洛地 成何   何洛洛   实力 门面   何洛洛 爸爸 节日快乐   宝贝儿子 做 蛋 饼 咯 尝尝 R1SE - 何洛洛 
 用户6420794537: 硬核 大爷 坐地铁 自带 logo  一路 风景 瑜 同行 黄景 瑜 1130 生日快乐 鲸鱼 忘记 粉丝团 老婆   
 兔兔仙鹅: 真的 受不了 电视剧 演技 剧情 时间 线烂 坨   xz 颜撑 都 看不下去 真的 再 看 吐 称呼 乱 莫名其妙 机兄 就算 十几岁 蓝湛 含光君 几个 ？   
 S__seven琴: 开心 工作 开心 生活 别太 为难 回忆 专用 小 马甲 : 想要 快乐     花泽 美美 : 好好 赚钱 ！ 别想 没   M 大王 巡山 : 想要 都 拥有 得不到 都 释怀 苍南 派 : 快乐 工作 快乐 生活 雨 玲玲 zjl : 愿 努力 不负 期望 ali _ thin : 求 减肥 Tiger 公子 : 再 生病 
 也就那回事2008_554:  朱一龙 朱一龙 0416 生日快乐   朱一 龙吴 邪   很 荣幸 陪你走 一段路 很 着想 这句 话 记上 十年 ！   L 吴邪 小 泥巴 _ 桃桃 微博 视频   
 Malemaker_0813: 李泰容 0701 生日快乐   ReinaMadre : 带 李泰容 0701 生日快乐   转发 这条 微博   明天 抽 一个 妹妹 请 吃 ladym 蛋糕   祝 偶们 bb 本命年 心想事成 身体健康 
 机智的孙某人: 愿 全力以赴 不留 遗憾 愿 成熟 被迫 愿 一生 努力 一生 爱 愿 一颗 童心 开心 快乐 ( 网上 听 喜欢 那句 愿 成熟 被迫 ) 化工 设计 真的 掉头发 乙炔 真的 人头 大 ( 蒸个 屁 馏 ) 孙不拙 真的 超级 无敌 聪明 ( 超 脸 ) 三观 真的 真的 很 ( 事       展开 全文 c 
 CoC冯笙o: 生日快乐 
 元气满满小盆友: 大概 马上 会 撑不下去   
 酸辣酱turbo: 高中 好好学习 ！ 回忆 专用 小 马甲   : 想要 快乐     花泽 美美   : 好好 赚钱 ！ 别想 没   M 大王 巡山   : 想要 都 拥有 得不到 都 释怀 苍南 派   : 快乐 工作 快乐 生活 雨 玲玲 zjl   : 愿 努力 不负 期望 ali _ thin   : 求 减肥 Tiger 公子   : 再 生病 
 Strawberry7Y: 八月 收到 大学 录取 通知书 新 生活 回忆 专用 小 马甲 : 想要 快乐     花泽 美美 : 好好 赚钱 ！ 别想 没   M 大王 巡山 : 想要 都 拥有 得不到 都 释怀 苍南 派 : 快乐 工作 快乐 生活 雨 玲玲 zjl : 愿 努力 不负 期望 ali _ thin : 求 减肥 Tiger 公子 : 再 生病 
 二点五次元涵OAO: 从来 学期 快要 完时 撑不下去 崩溃   
 Neveda_: 够 好 尽我所能 ？ 看不见 不在乎 ？ 期待 越大 失望 越大 都 撑不下去   
 係贝拉唔係备啦: 这段 说 普通话 听 不 ！ 尴尬 
 lovepdsjw_2000: 总有 撑不下去 不想 回头   
 仔仔糖糖宝贝滴妈: 天气 太 热 天气 去 南京 武汉 真怕 撑不下去   
 豆奶拿铁超好喝: 李泰容 0701 生日快乐   _ Schlafen : 带 李泰容 0701 生日快乐 转发 本条 微博   明天 抽 一位 送 纳西 素 香水     30ml 祝崽崽 生日快乐 请 多多 喜欢 泰容 
 幽然思怀思永: 南 南 生日快乐 翟潇闻 听话 麻麻 爱 R1SE - 翟潇闻 
 梦小盈盈: 想不到 吃 一盘 半 龙虾 吃 喝 好多 鸡汤 还 吃 三个 水饺 两块 蛋糕 吃 西瓜   超甜 超多水 饭局 九点半 结束   还 撑 躺 不 吃 付出代价   2 淄博   
 阮兔兔也要冲鸭: 开开心心 辣条娘 : 怕   勇敢 一点 好 一点 M 大王 巡山 : 想要 都 拥有 得不到 都 释怀 苍南 派 : 快乐 工作 快乐 生活 雨 玲玲 zjl : 愿 努力 不负 期望 ali _ thin : 求 减肥 Tiger 公子 : 再 生病 
 藏起来的我hhh: 努力 克制 努力 控制情绪 努力 现状 往好 方向 发展 会 管不住 思想 情绪 安神 补 脑液 天天 喝 助眠 视频 一个 一个 看 不行 不 没人 懂 痛苦 说 矫情 压 真的 好累 好 累 白天 真的 控制 下 晚上 处于 崩溃 界限 撑 不下       展开 全文 c 
 用户6493362933: 男   都 信   嘴上 说 爱   天天 秀 恩爱 信   不想 谈恋爱   很多 想 做 事   想 做 做   不 钱 不   太多   我要 快乐   没 男朋友   不 喜欢 凑合   
 比比比斯鲁: 五月 青枫 : 93 级 ！ 不 62 级 高资   还 撑下去 
 王十三是傻子: 人 避不开 生死相依 相随 共 离别 不舍 踌躇 之间 想 活下去 心 跳动 撑 满满的 不舍 遗憾 没 办法 憧憬未来 想象 来生 一路 徘徊 相忘 不止 江湖 走 一遭 苦乐 人生   
 小金比白: 快乐 时 不用 分心 想起 难过 时请 记得 联络 分享 苦 带走 忧愁 拥有 些   
 梨涡的圆周率: 不 优酷 刷 街舞 这烂 节目 视频 不 给予 热度 看千玺 只 看 cut 到时候 贵 节目 还 高 热度 做 贵 节目 您们 所宠 几位 队长 粉丝 节目 撑 多久 ？ 
 Cececelia_: 两天 心态 真的 一点 爆炸 一点 受不了 生活 上 周末 班好 不 值得 想想 不值 再 一点 动力 都 信念 支撑 好 累 还要 撑 三个 月 才能 熬 到头 两个 月 不到 一点 计划 都 提前 考 多天 压力 一下子 涌上来 才 好 崩       展开 全文 c 
 顶级难泡玫瑰茶: 日常 纠结 买手机   手机 撑不下去 不想 修   立马 换 不了   XS   MAX   XR 8P 之间 纠结 喜欢 8p 拍照 效果   据说 打游戏 很 流畅 众多 测评 里 表现   总 感觉 买 新 不 买 旧   怕 Xs   max 信号 不好   变砖   毕竟 价格 不 便宜   大 重 喜欢 白色 xr   信号 不 咋办         展开 全文 c 
 小小的小蔓蔓的蔓蔓: 承认 我过 一点 不好 很多 真的 都 熬 不   快要 崩溃 不 压力 改变 都 太 好多 事情 真的 接受 不了   无力 抗拒 只能 哭 完 再 爬起来 老老实实 走 这辈子 从来 没 坚强 大小 坎 都 死 撑过去   孩子   长 点心   好   
 shine想过: 担心 老钟 身体 担心 指南针 撑下去 不 担心 毕竟 死立 执 死缓 差别 恨   
 爱笑又爱哭的小雯子: 人生 总有 一段 孤独 走 时光 理解 撑下去 好   
 要努力考上研究僧的禾: 回归 大三 说 再见   经历 一个月 期末 复习   考试 周   课设 周   熬 两个 星期   通 两次 宵   算是 通 一夜 去 验收 课设   放 几天 假   一个 学期 完完整整 放过 假   不 真的 撑不下去   一个月 真的 折磨 放假 好 快 落 ！ 好       展开 全文 c 
 一盒小崽: 特哥 生日快乐 
 我的西皮可能每天都很甜: 快 到期 快要 撑不下去   
 peng勒:  郭子 凡 0711 郭子 凡 生日快乐   年少 欢喜   七月 第一天   郭 老师   晚安 呐   
 西西很甜i: 七月 一切顺利   希望 不挂科   快乐 暑假   
 莱尔LAZA: 硬核 大爷 坐地铁 自带 logo 写给 九句 话 撑不下去   
 小骄傲的专属FD: 感觉 得不到 安全感 真的 累 好 累 打起精神 面对现实 面对 真的 撑不下去 不 ？ 有时候 冥想 到底 活下去 ？ 来到 世界 上 使命 ？ 累 就要 永远 休息 家人 朋友   
 Bevshyu-: 求求 认真学习   好好 努力   真的 再 玩 吃 真的 很肥 开心 呜呜 再 难 加油 撑下去 M 大王 巡山 : 想要 都 拥有 得不到 都 释怀 苍南 派 : 快乐 工作 快乐 生活 雨 玲玲 zjl : 愿 努力 不负 期望 ali _ thin : 求 减肥 Tiger 公子 : 再 生病 
 沙玛釰钬: 集市 上 鱼 水分 蒸发 差不多 时常 就要 撑不下去 适时 吝啬 地洒点 水 便 再 提着 一口气 蹦 哒 两下 作出 生龙活虎 样子 看   前途 未卜 痛苦 里 周而复始   死 偏 不肯 温柔 豢养 分享 单曲 K 心酸 （ 网易 云 音乐 ）   
 Curly-Fool:  名 侦探 柯南 每次 刷到 这集 心疼 死 真的 看不下去 柯南 重 感冒   难受 还 强撑 推理 会 照顾 ！ 小兰 不 关心 好 想 抱 沉重 身体 不用 站 难受 晕倒       展开 全文 c 
 WastedinSyrup: 哥哥 生日快乐 ！ 去 见 林宥 嘉 0701 生日快乐 ## 林宥 嘉  林宥 嘉   
 小琛超乖: 回复 R1SE - 姚琛 : 都 好好 加油 噢 ！ 加油 加油 ！ R1SE - 姚琛 : 生日快乐     
 冰镇西柚蝙蝠派: 热 搜去 看 些 恋爱 剧 好几部 第一集 都 撑不下去 无论是 校园剧 校园 延伸 职场 剧 一部 剧 男主 调换 违和感 都 一个 模板 纸片 人 真实 口区 电视剧 市场   
 重新遇见了你: 我快 撑不下去 开心 不 开心 装作 开心 在乎 人 就要 吵架 扬言 离开 ？   
 棉花糖天空堂主: 宋仲基 颜值 撑 第八集 实在 看不下去 太 做作 、 太 难看 老年人 粉丝 骂 恕我直言   
 _张二朵: 七月 盛夏 快乐   
 繁华6143121420:  晚安 语录 人 独自 前行 任何人 都 帮不上忙 再苦 再 难 撑下去 有时候 真的 想象 还要 强大 微博 贴纸   
 陈鹿陈路陈璐霏: " 职场 人生 点滴 1   道歉 不 伤害 自尊 2   慢些 瞬息是两个宝宝: 好 祝你快乐 
 伱算阿貓还阿豿: 不忘 初心 九句 话 撑不下去   
 Ephemeraaa: 所见   全都   酒 、 女人 、 神   、 家族   、 王 、   梦想 、   子女   、 力量 人 不 沉醉于 东西 估计 都 撑不下去 所有人 都 事物 奴隶 沉醉于 ？ 英雄 ？ 出 想 半天 真的 沉迷 事物 做 都 不 上瘾       展开 全文 c 
 渣妹纸: 撑下去 计划 清单 列表 事情 去 做   查看 图片   M 大王 巡山 : 想要 都 拥有 得不到 都 释怀 苍南 派 : 快乐 工作 快乐 生活 雨 玲玲 zjl : 愿 努力 不负 期望 ali _ thin : 求 减肥 Tiger 公子 : 再 生病 
 绝版AD钙: 越来越 想 回家 感觉 快 撑不下去   2 福州   
 _相葉豌豆酱: 较量 一个月 都 撑不下去 确实 办法 一个 人 生活 废物 信誓旦旦 行 每次 大事 小事 只会 哭哭啼啼 解决问题 方法 可笑 幼稚 不了 外卖 选择 不吃 天然气 坏 洗 冷水澡 天气 不好 不到 车 上班 请假 不去 上班 一个 没用       展开 全文 c 
 AlexBe巛n-_827: " 想起 小时候 吃 冰棍 感觉 碎碎念的瓶: 妈妈 想 留在 家 却 一口 否决 安稳 生活 样子 大概 不 排斥 想 看 外面 世界 真的 撑不下去 再 回家 还 年轻 容错 成本低 再 努力 真的 努力   
 韩畅刘芯言今天结婚了吗: 大概 策划 暑假 干什么   特别 特别 想 回家   多天 都 熬过去   剩 4 天 撑不下去   好 想 回家   
 苏毓七七: 家 撑下去 不 感情 孩子 现代人 过不下去 还要 孩子 硬撑 ？ ！ 无趣 无爱 浑浑噩噩 ～   
 不爱吃东西阿: 六月 末 奇遇 衔接 七月份 快乐   
 Hello米小乐:   一本   有壁 够 撑下去 ！ ！ 明天 名 场面 玫瑰 吻 就要   激动 睡不着 哈哈哈哈   
 ·樱花草莓星冰乐·: .... 孟 女士 真的 看剧 阻力 我快 撑不下去   
 VivienneMe: 陈情 令   不行 撑不下去 弃 Wi - Fi 潇洒不羁 少年郎 娇俏 可人 小 郎君   
 Osmanthus_旺旺: 李汶翰   0722 生日快乐   好 东西 ！ ！ 简便 直达 UNINE _ 李汶翰   李汶翰 软糖 沙滩 
 仙女要一夜暴富-: 好像 稍微 安心 一点 宝贝 真的 好棒 天生 爱豆 ！ ( 追 404 段时间 发过 微博 最 一段时间 ) 反正 快乐 提到 ugi 都 夸夸 宝贝 开心 开心   
 子薇格格wei: 倒计时 day14 学校 里 撑不下去   宿舍 风扇 坏 一年 报修 好 几次 都 说 修 只能 换   夏天   早上 四五点 热醒   一身 汗   每天晚上 会 断电   小 风扇 电能 充 不了   脆弱 睡眠   四五点 醒 再也 睡不着   白天 上课 好困     贼 烦人   磨 不想 吐槽   
 Lucky_阿柒: 孔侑 孔孝真 看 老剧 光看 脸 都 撑不下去 剧情 人物 真的 年代 感太强 老套 不行 当年 极道 鲜师 看 完 ？   
 小柠理想型: 真的 撑不下去 算了吧   
 lycorislonly: 確有 很多 更 艱苦 人 努力 生活 努力 過 這種 不想 活 無力 感為 什麼 還不走 不 去 看中 醫我媽 問醫生 吃 飯 沒 ？ 病人 這麼 很累 醫生 說 喜歡 事 運動 不喜歡 才 勞動 也許 他們 為 努力 人才 能撐 沒 說 後 父母 無動 於 衷 個       展开 全文 c 
 小丫头和蓝星星: 我快 撑不下去 要死   
 Angel34724: 承认 我过 一点 不好   很多 真的 都 熬 不   快要 崩溃   不 压力   改变 都 太   好多 事情 真的 接受 不了   无力 抗拒   只能 哭 完 再 爬起来 老老实实 走   这辈子 从来 没 坚强   大小 坎 都 死 撑过去   
 王阿宅a:  燃烧 陀螺仪 天气 天意 七月 你好 ！ 亲爱 党 生日快乐 ！ 大哥 下半年 燃烧 嗷 ！   
 侬本多梦_770: 坠崖 孕妇 遭 男方 家属 辱骂 愿 愿望 都 生日快乐 ！ 肖战 1005 生日快乐   
 tanB_CandyGre_: 李泰容 0701 生日快乐   Cupido _ 李泰容 安利 博 : 李泰容 0701 生日快乐    李泰容   泰容 大一岁 生日快乐     愿 努力 辜负   愿 身体 不用 再 受伤   愿 平安 喜乐 有奖 转发   转发 这条 微博带 话题 李泰容 0701 生日快乐   抽一人 送泰容 生日 手链   为泰容 庆生 
 用户6170208265: 中国 失踪人口 档案库 官网 : 回复 平安 随州 : 儿子 快 回家吧 妈妈 撑不下去 ！ 爸前 几天 出车祸 紧急 救治 刚刚 脱离 危险期 哀怨 查看 图片   平安 随州 : 随警 提示   请 扩散 ！   
 onedaylme: ioi 重组 官宣 wtmxsl 人 真的 太 搞笑   请 夏 都 撑起 solo   都 做出 成绩 才 真的 重情 重义 好   国内 蹚 浑水 混不下去 败 名声   真的 占 大 便宜 好   居然 有人 说 话   真的 生气   便宜 还 卖乖   
 盒洛洛落地不成盒: 撑下去 加油 明天 晚上 凤凰 不 恩施   
 凌小晚: 感觉 快 撑不下去   
 枭不拉屎大王: 致残 打击     信心     撑不下去   
 帅气机智哒浴帽超人酱: ？ 真的 撑不下去 委屈 要命 当初 分配 这项 工作 本来 超出 能力 明明 是因为 人 去 做 去 做 才 会 分配 没法 拒绝 想 学习 提升 不 这项 工作 高 精细 只用 做 一件 事       展开 全文 c 
 2qiRlbJ: 实在 撑不下去   
 -ORANGECJ: 象山 影视城   29 号 自驾 一波 去 象山 影视城 无奈 30 号 一波 强降雨 心疼 全湿 掉 yeezy ... 还好 景区 边上 有个 剧组 超市 还 挺 实惠 买 双拖孩 15 块 撑起 游玩 信心 景区 门口 吃饭 不贵 都 价格 景区 后 便利店 都 无人 便利店 感受 科技 先进 那种 小黄       展开 全文 c 
 Boom_LD: zxc668   龙王 小儿子 龙云略 思忖 提议 道 爹 要知 先 休兵罢战 试试 杨浩 心意 至少 借此机会 将士 稍作 歇息 恐怕 真的 撑不下去   
 简单学习网允儿老师: 真的 一点一点 都 不想 学习 不 学习 不 会 时代 淘汰 别人 讨论 会 说 只会 干什么 都 世间 机会 会 选择 只能 撑下去 知识 难 看 几遍 能看懂 看 看不去 逃避 能看懂 ？ 都 努力       展开 全文 c 
 现实浪漫主义: 快点 考完 放肆 找 哭 真的 撑不下去   
 兔儿买白菜: 天上 小雨 撑 伞 散步   想 笨蛋 不 主动 ？ 路过 小桥 时   故意 伞 扔 河水 里 愣住   笑 说 一个 人 淋雨 ？   恍然大悟 咻 一声 伞 扔下去   
 阿拉拉拉朗LANG: 问 世间 最 坦荡 高嘉朗 JG     KBeginning （ 起点 ）   打榜 当仁不让 ！ 亚洲 新歌 榜       打榜 快乐 吖 ！   
 再来一口吧要不: 请 好好 努力 备研 上岸 ！ 小羊 爱 吃 酱 肘子 : 想要 爱 朋友 都 好好 ！ 回忆 专用 小 马甲 : 想要 快乐     花泽 美美 : 好好 赚钱 ！ 别想 没   M 大王 巡山 : 想要 都 拥有 得不到 都 释怀 苍南 派 : 快乐 工作 快乐 生活 ali _ thin : 求 减肥 Tiger 公子 : 再 生病 
 是一只菜呀: 抱 刚 买 奶盖 茶 摔   胳膊 撑 怕 奶盖 撒   直挺挺 跪   膝盖 上 好大个 疤 
 喵性女孩P: 睡 : 消防员 撕心裂肺 哭声 还 记得 努力 猫 阶级 : 记得 女孩 跳楼 前 消防员 说 谢谢 真的 撑不下去 苦苦 挣扎 那段 黑暗 时光 里 不到 一句 抓 
 最没有原则的仙女: 真的 太 烦躁 太委屈 撑不下去   
 爱诺玛亚精油: 硬核 大爷 坐地铁 自带 logo [ ]   小 咖秀 我滴 妈呀 ！ 有沟 必火 ！ 胸前 两张 贴纸 鬼 L 小熊 班尼 秒 拍 视频 快乐 对口型 小 咖秀 ！ → _ → O 小 咖秀   
 大裸朵: 点 一份 盖饭 盖 点菜 肉 少 亲妈 都 不 一份 盖饭 盒子 白米饭 两片 （ 夸张 两片 ！ ） 菠菜 两块 土豆 狠 一点 扒拉 菜 坨 米饭 思考 扔 垃圾 还 换个 盒子 全 吃 完 好撑 垃圾 分类 使人变 胖   值得 开心 都 干 垃圾       展开 全文 c 
 GraceGuo--: 学会 快乐 人 ； 1 ； 简直 浪费 感情 满腔   
 今后不会再为小赵哭鼻子了: 吃瓜 群众 CJ : 快 一年 睡 : 消防员 撕心裂肺 哭声 还 记得 努力 猫 阶级 : 记得 女孩 跳楼 前 消防员 说 谢谢 真的 撑不下去 苦苦 挣扎 那段 黑暗 时光 里 不到 一句 抓 
 Hey就不能找个大点的碗么: 上海 垃圾 分类 扔 错 罚款       实行 垃圾 分类 本来 吃不完 外卖 通通 逼 撑下去     好 ！ 烦 ！   
 sehun奶罐: 暑假 快乐 努力 挣钱 
 好的呀好看呀: 撑不下去 只能 告诉 死 不起   
 candygigi000: 下班 快乐   2 西安 · 鱼化 寨 地铁站   
 王和姚: 请 姚琛 小朋友 永远快乐 R1SE - 姚琛   R1SE - 姚琛 :  R1SE                     入住 新 家 快乐 ～     10 年   20 年   30 年 R1SE Family       Together   Forever           
 天津忙人: 别人 快乐 [ 甩 甩手 ] 
 手之所植: 生日快乐 ! ( ^ O ^ ) y 
 合院彭于晏丶: 生日快乐           
 岳西婚庆金玉良缘_331: [ 超话 ] ## 0416 生日快乐   0416 生日快乐   这是 lv 居 好帅 成熟 男人   L 吴邪 小 泥巴 _ 桃桃 秒 拍 视频   
 皮皮虾骑士落叶:  第五 人格 真的 撑不下去 好想 退游 五阶一 13 分 掉下来 队友 疯狂 制裁 不让 上 六阶 开局 溜 60 秒 换人 追 四 杀 真的 再也 不 殿堂 留给 混子 演员   
 小指头小指头: 好 累 感觉 撑不下去   
 小不点和锤锤: 去年 6 月 不顺 心中 有结 想要 过得 快乐 一点 18 年底 劝 说 19 年 中 下半年 第一天 很 好 改善 反而 越活 越难 话 连个 聊聊 人 都 朋友 只能靠 不 撑不下去 不 会 情况 抑郁 牢笼   
 这世界让你紧张害怕吗: 快要 撑不下去 53 天给 灌 一碗 毒 鸡汤   
 丝莫尔青: 温情 吹笛 驭 尸 玩意 ？ ？ ？ ？ 加戏 就算 ！ 加江 澄 孟情 感情 戏 算了 ！ ！ ！ ！ ！ 魔 道 祖师 懂不懂 夷陵 老祖 第一 人好 ！ ！ ！ ！ 《 陈情 令 就算 肖战 盛世 美颜 jio 快 撑不下去 ！ ！ 孟子 义 这位 小姐姐 真的 赢 毁 魔 道 祖师   
 花果山的护林员: 读书 做事 少东 想 西想 尸姐 : 再 钻牛角尖 辣条娘 :   怕   勇敢 一点 好 一点 M 大王 巡山 : 想要 都 拥有 得不到 都 释怀 苍南 派 : 快乐 工作 快乐 生活 雨 玲玲 zjl : 愿 努力 不负 期望 ali _ thin : 求 减肥 Tiger 公子 : 再 生病 
 shine想过: 担心 老钟 身体 担心 指南针 撑下去 不 担心 毕竟 死立 执 死缓 差别 恨   
 小程的小小宇宙: 七月 拜托 宝贝 TFBOYS - 易 烊 千玺   好 一点 张桢 玺 : 7 月 加油   梨寒 : 六月 真的 快乐 伤痛 并行 小北 迎来 李必 街舞 乱 剪里 秃头 十二 争气 里 笑 开花 希望 七月 请 对崽崽好 晚安 
 安利菌: 拍可孚 都 囤 一个 小时 抢 几万 件 库存 ！   2 片装 只 剩下 8 千件 ！   刷新 掉 好几件 速度 估计 撑 不了 多久 还 想 囤 快   安仔 翻 下 评论 大部分 蛋仔 都 好用 肤质 感 般的   蛋仔们       展开 全文 c 
 文丽妮子: 撑不下去 心情 烦躁 迷茫 就读 一遍   1 清醒 时 做事 糊涂 时 读书 大怒 时 睡觉 独处 时 思考 2 再 难 再 好 淡泊 再 差 再 节省 3 路 不必 别人 标准 框定 人生 4 才华 撑 不起 野心 时       展开 全文 c 
 _WekiNaNa_: 傻帽 孩子 脸   创意 真的 弄 不 SixYeDam : 放心 创意 都 是因为 帽家 孩子 脸 撑起来 
 张啊啊啊啊艺: 55 分钟 撑不下去 睡觉 第十四 年 酒肉朋友 狐朋狗友 塑料 姐妹 XLiHNNiu   祝 开心   
 苏毓七七: 家 撑下去 不 感情 孩子 现代人 过不下去 还要 孩子 硬撑 ？ ！ 无趣 无爱 浑浑噩噩 ～   
 valeriantaker: 周末 看 两天 书   昨天晚上 撑不下去 十点 睡   定 6 点 闹钟   没 每节课 阅读 量 电脑 上 死 都 看 不 进书 习惯   明年 选 课会 死   九月 回来 还 再 研究 研究 课     
 一只脾气暴躁的小火龙: 养成 一到 下午 四五点 困到 灵魂 出窍 不 睡觉 撑不下去 习惯 ？ ？ ？   
 疯崽守护联盟: 一个 rock   bro 联动 登山 尹 代表 撑 小 透明 伞 爬山 去 哈哈哈   
 嘴角的微笑jie: 祝 小宝宝 生日快乐 身体 棒棒 哒 笑容 天天 有余 生有 爱   
 一颗biubiu橙: 好好 吃饭 好好 睡觉 好好学习 开心 回忆 专用 小 马甲 : 想要 快乐     花泽 美美 : 好好 赚钱 ！ 别想 没   M 大王 巡山 : 想要 都 拥有 得不到 都 释怀 苍南 派 : 快乐 工作 快乐 生活 雨 玲玲 zjl : 愿 努力 不负 期望 ali _ thin : 求 减肥 Tiger 公子 : 再 生病 
 我喜欢所以你喜欢: 想 说 长大 好多 烦恼 小时候 开心 话到嘴边 憋 回去 天天 都 吃苦 小时候 很 艰难 时刻 小时候 小口 小口 吃苦 长大 张大嘴 吃 承受 苦 能力 变强 才 会 捧 开心 大笑 吃苦 哪有 尽头 苦尽甘来 撑不下去 力气 向前 看 倒霉       展开 全文 c 
 蜜论: 18 岁 年龄       听 28 岁 人 歌     38 岁 经历       混 还 8 岁 小孩 好     确实     一个 人 过早 成熟 会 很多 同年 人该 快乐   
 Ziho智豪: 感觉 情怀 快 撑不下去 哈哈哈哈 
 宁建院鲁鹏飞: zxc668   杨浩 摇头 道 一鼓作气 ？ 攻城 之战 哪有 三天 五天 十天 半月 ？ 连番 大战 之下 兵 铁打 哪有 不累 不乏 再者说 刚刚 招纳 降兵 扩张 大 地盘 大 一块 肥肉 吞下去 总得 稳 稳妥 妥地 化作 腹中 食物 才 好 想要 一口 吃 成个 胖子 还 不 撑   
 ziiguu: R1SE 姚琛   y c# 姚琛 Cookies     不悔 不虑 未来 做好 姚琛 加油 ！   出 道 快乐   R1SE - 姚琛   
 俊櫋: 今日 快乐   说 下午 学不 看 一集 电视剧   舍友 说 图书馆 平板 干 事情 超   前 几天 很 远 一个 男生 平板 玩 蜘蛛 纸牌   一个 舍友 说 手机 里 下过 扫雷   袁 爷爷 吃 太饱   吃饱 撑 干 事 哈哈哈 哈哈哈 哈哈哈 哈哈哈 哈哈哈 哈哈哈 哈哈哈 哈哈哈   
 来一分钱TM糖: 七月 第一天 倦   撑不下去   耗 才 十几个 号   
 你的美丽呀wW: 一个 沾床 睡着 人   竟然 失眠 只能 祝 七月 第一天 快乐 快快乐乐 真的 好 想 睡着   很火 一句 话 烟火 气 最抚 凡 人心                                                                                                                     2019.07 01     2 滨州 · 滨州 职业 学院   
 用户zir2bdya1h: 好苦 好苦 情绪 交织 加上 阴差阳错 误会 所有人 不 快乐   
 用户6767380645: 才 没用 垃圾   「 真的 撑不下去 」 啜泣 脸 埋进 双手 拍 肩膀 鼓励 「 撑下去 ！ 难道 忘 时 我俩 许下 誓言 ？ 300 一个 人 自助餐 ！ 」   
 上海百济韩国语中心: 百济 韩国语 早安 百济             感觉 撑不下去 瞬间   最终 都 会     
 yuanyuanyuanyuanyuan-: 吃     撑 坐 不   绝望   
 無山一岚: 减点 肥 搞 点 钱 天才 鼻屎 : 瘦 十斤 世界 真的 不 M 大王 巡山 : 想要 都 拥有 得不到 都 释怀 苍南 派 : 快乐 工作 快乐 生活 雨 玲玲 zjl : 愿 努力 不负 期望 ali _ thin : 求 减肥 Tiger 公子 : 再 生病 
 BvHS9-孟浩然ana: " 钱 很 帮 很多 人生 梦想 人生 快乐 钱 太多 关系 希望 人 都 快乐 赚钱 我是一只猫x: 总 肚子 上 肉 特别 坐 想 做 瘦 腹 运动 平板 撑 撑 不到 十秒 不 加上 天气 热 放弃 今日 瘦腹 运动 — — 失败   
 再见了您呐_: 回忆 专用 小 马甲 : 想要 快乐     花泽 美美 : 好好 赚钱 ！ 别想 没   M 大王 巡山 : 想要 都 拥有 得不到 都 释怀 苍南 派 : 快乐 工作 快乐 生活 雨 玲玲 zjl : 愿 努力 不负 期望 ali _ thin : 求 减肥 Tiger 公子 : 再 生病 
 是亲卿吖: 承认 我过 一点 不好 很多 真的 都 熬 不   快要 崩溃 不 压力 改变 都 太 好多 事情 真的 接受 不了   无力 抗拒 只能 哭 完 再 爬起来 老老实实 走 这辈子 从来 没 坚强 大小 坎 都 死 撑过去     ○ ○ 女头  女头  女 头像       展开 全文 c 
 一朝一暮是茶欢: 2019 年 一半 上半年 结束 时间 过得 很快 小卢 同学 快 半年 有时候 很久 有时候 没多久 期间 发生 大大小小 很多 事情 吵吵闹闹 很 有时候 实在 过不下去 才 几个 小时 想 想到 不行 晚上 都 撑 不 脾气 很 爆       展开 全文 c 
 派大星你好呀1: 快乐 不   20 岁 只 阳历 生日   是因为 真的 33 岁   一无所有   还 负债   大概 我活 最 凄惨   乐观     健康 负累   都 撑不下去   真的 一无所有   都     美好 东西   好 感情   越 贫穷 越 不堪   越来越 累   说句实话   想到 死 解       展开 全文 c 
 橘子蔚七分甜: 快乐 满载而归   快乐 分享   
 Ivanwen钧: 2019 只 剩 一半 童年 充满 快乐 趣味 甜蜜 ； 童年 一颗颗 闪亮 小星星 照耀 未来   
 行走的体型裤: 想发 下半年 第一天 好 七月 你好 [ 大 侦探 皮卡丘 微笑 ] 想起 还 花 打开 支付宝 看 看卡 余额 这回 真的 透支 hhhh 距离 开 工资 20 天 撑下去 体型 裤 语录   上个月 麻麻 救济 总 麻麻 救济 班上 光出 不进 吃不消       展开 全文 c 
 冬与夏夜里的星空: 肖战 魏无羡 很 满意 真的 帅 这张 脸 强撑 看 三集 再也 不 看 羡羡 cut   
 Motif米田: 老朋友 感谢 陪伴 三两 合欢 :   用过 湖畔 模式 很 舒服 下架 零星 导出来 数据 忘 用米 田 真的 换 手机 必备 app app 苹果 手机 定期 上线 刷 更新 看遍 开发人员 介绍 担心 运行 会 将来 撑不下去 还 发过 信息 感谢 辛苦 加油 
 爸爸的宝贝女儿: 七月 我要 快乐   
 夏末微凉cwy: 小迷 兔 周边 周边 : 莫 强求 词 全新 青锋 裁月 : 哈哈哈哈 哈哈哈   七七 郎 _ 一只 鸽子 咕咕 咕 :   哈哈哈哈 喵 星大狼 狼 : 本来 电影 后 对莫斯 讨论会 人类 只能 机器 苛求 理性 禁止 想到 画风 走向 哈哈哈 微博 沙雕 快乐   
 火钳-ink: urUmbrella : 加油 鸭 ！ 梨寒 : 六月 真的 快乐 伤痛 并行 小北 迎来 李必 街舞 乱 剪里 秃头 十二 争气 里 笑 开花 希望 七月 请 对崽崽好 晚安 
 朱婉玲: 人生 哪能 事事如意 ； 生活 哪能 样样 顺心 不 小人 较真 不 值得 ； 不 社会 较真 不起 ； 不 较真 伤不起 ； 不 往事 较真 没 价值 ； 不 现实 较真 善良 宽容 ； 责任 承担 ； 某种理由 ； 妥协 看轻 快乐 ； 看淡 幸福         展开 全文 c 
 cranberry_琳: 不 吃 肚子疼 种想 吐 感觉 人 身体 20 真的 感觉 下 一个 台阶 忽然 想起 很多年 前 人 说 经历 苦难 下次 能撑 多久 撑下去   
 手机用户3301402805: 宣酒 6 上市 热销 一周年   生日快乐 一阵 飞鱼 唯爱允 西卡 嘴角 扯 出 微笑 
 cool小拉: 讲评 试卷 气绝 快到 暑假 撑不下去   
 杨洋的小陌冉: 七月 ## 七月 ## 七月 你好   七月 你好 毕业 季 你好  杨洋   杨洋   愿 大 男孩 天天 快乐 都 爱 笑 请 世界 温柔 点 杨洋   
 Teresa高小亚: 夏天 却 扭过头去 看不见 理想 生活 之间 距离 不 明白 远 撑下去 K 理想 人 不 伤心   
 红豆奶茶收藏家:   好像   撑不下去 
 释怀__那紫色: 张艺兴脑 洞大开   吃火锅 嗑瓜子 还要 搞个 炕   暖心 支招 李荣浩 主持 技巧 张艺兴 下次 搞 一个 火锅 主持 谈笑风生 李荣浩 马上 一个 人 讲 五组 实在 撑不下去 cue 一下张 艺兴 太干 说 召唤 不荣艺 组合 李荣浩 俩       展开 全文 c 
 你看树上有只猪也:   怜爱   想起 小朱 上半年 差不多 状态   真切 列出来 行程 安排表 明白 咳复   一个 感冒 拖 半年   骂 公司 不 做人 红 代价   偶像 不温不火 这一说   抠 脚   刀山火海 千难万难 撑下去 ギ リ ギ リ   
 想曾经才清醒: 2019 年 下半年 正式 19 年 上半年 事情 都 忘掉 找回 自我 找回 从前 快乐 还 会   
 Yvub1-防患未lwq: 哭 不 代表 屈服 ； 退一步 不 象征 认输 ；   放手 不 放弃 ； 微笑 不 意味 快乐 !   
 这个孩子有点怂: 剪 小学生 头 姐妹 生日快乐 ！ 只约 学习 局   都 野 Aaaa 阿珂 姐姐   艺涵 YA   太太 太太 太太 嗨   思思 乖 五月 孤岛   
 feminine比基尼462: ！ ！ R1SE - 姚琛 :  R1SE                     入住 新 家 快乐 ～     10 年   20 年   30 年 R1SE Family       Together   Forever           
 炸裂队长: 现金流 事儿 太 这是 创业 公司 最 看重 一点 公司 无论如何 都 一个 始终 赚钱 项目 保证 月 都 稳定 资金 输入 才能 调整 业务 规模 公司 营收 项目 不 稳定 员工工资 、 办公 开支 维系 撑 不了 几个 月 撑不下去 很多 公司 都 死 没 钱 路上       展开 全文 c 
 WANHUA--:  十年 一品 温如言言 生日快乐 ！ 往后 余生 言 太太 幸福 （ 希望 西安 天气 祝福 ）   
 文酱很靠谱: 快 撑不下去 好 一点 ！ ！ 
 用户7132325382: 慈父 辛苦 ！ 感谢 人生旅途 中 一路上 ！ 一种 责任感 来自 男人 一种 承担 父亲 一种 无言 父爱 人生 沧桑 、 生活 重担 、 责任 重担 时间 带走 青春 岁月 抹 灭 容颜 父爱 却 座 山 始终 屹立 不倒 献给 天下 父亲 节日快乐 ！   
 全息隕星: 李泰容 0701 生日快乐   辛苦 
 龙龙小甜宝: 一点 都 不 可爱 518 : 小时候 天天开心 快乐 祝福 太俗   太 没 深度   没 内涵   天天开心 快乐 最 美好 最 祝福 
 Awesomelulu: 沙雕 快乐   
 akat中華包: 我来 无脑 吹 冨 冈 义勇 绝美 男人 都 极限 却 撑住 不 睡下去 安安静静 帮炭炭 包扎 伤口 还 关心 伤势 冨 冈 义勇 喜欢 灶门 炭治郎 把头 拧下来 当球 踢 （ ）   
 _木棉姑娘__: 下半年 第一天 放假 倒计时 2 天 （ 真 撑不下去   牙疼 腰疼   sa 叭 前 几天 吃     火烧 牛肉 馅 太太 太足 万年 点 奶茶 不 动脑子 人 终于 尝试 新品 （   幽兰 四季春   蛋糕 刚刚 考完试 心情 变得 好好 滴 维他 奶   太 可爱 拍 可爱 滴 轻食 外卖               展开 全文 c 
 mUsiC_Nm岚: 宣酒 6 上市 热销 一周年   一周年 快乐 ！ 祝 越来越 好 ！   chenxFeng 建   嘉   Ivanwen 钧 
 糯米团子鸭鸭鸭: 永远 都 摊上 样子 犯贱 爸妈 快 饿死 房里 挺 不   真的 撑不下去 真的 饿死 房间 判刑 不好过   没事 有时候 想要 极端 自残 发泄   想 死 掉   摆脱 一点 痛苦   伤心   会 惩罚   痛苦       展开 全文 c 
 blackwhite__whai: 不认 怂 没 办法 撂倒 我要 加油 撑下去 忍住 上司 神经病 
 戏人老朽: 哥哥     都 近乎 崩溃 状态 下 度过     都 问     我能 撑下去     我能   支撑力 太小       选择     逃不掉   别人 每替 惋惜     更 疼       想想     我会 好受 点         （ 希望 不 小心 掉 进 沼泽地     明年 走 花路 ） 
 公証人: 撑不下去   
 飞鸟与鱼先生:  周震南 周震南 0621 生日快乐   恭喜 咱家 超话 喜提 第五   姐妹 棒 ！ 看 官博 物料   发现 南南 音乐 真的 热爱 真的 希望 听到 更 建议   渴望 那种 真切 恳求 请 谱 专业 音乐 人来 教 孩子 ！ R1SE 官博   会 越来越 好 ！ 吸引 更多人 目光 ！ 舞台 上 R1SE - 周震南   最 光芒四射       展开 全文 c 
 想取个名字叫可乐: 撑不下去   
 橘子苞米花蔚: 撑不下去 
 半罐子甜e: 快乐 警察 抓走 不 开心   2 淄博   
 哎呀呀我还在等: 七月 你好   不再 我明 饮鸩止渴 却 甘之如饴 我怕 没 稻草 真的 撑不下去   
 障障小宝贝_: 挂水 快好了   荷包 撑不下去   
 准合口味: 日常生活 中   迫切 寻找 精神支柱 爱豆 过日子 一点 小事 都 撑不下去   会 想想 爱豆   音乐   品格   铸造 一个 理想 榜样   完美 榜样     爸妈 没少 支持   我妈 太过 支持   希望 我能 开开心心     有太多 烦恼   身体 健康   都 吃得饱 饱       展开 全文 c 
 小丫头和蓝星星: 我快 撑不下去 要死   
 ABC别想太多: 多么 硬 都 不得不 低头 好 恨 两个 声音 一个 真的 受够了 趁早 快刀斩乱麻 一个 再 坚信 老天 考验 撑下去 卡 蛋 动 疼 不动 持续 疼   
 蚂蚱腿子dioica: 七月   快乐   
 丁丁dinghaiyan: 新人 很多 不 基本权利 维护 导致 压力 很大 情况 变得 很 糟糕 精神 不好 身体 撑不下去 说 还 惭愧 想 一个 小朋友 上课 老师 说 想 上 厕所 年纪 大小 提出 合理要求 都   
 阿怪Juy: 六月 散装 快乐   
 Angel34724: 承认 我过 一点 不好   很多 真的 都 熬 不   快要 崩溃   不 压力   改变 都 太   好多 事情 真的 接受 不了   无力 抗拒   只能 哭 完 再 爬起来 老老实实 走   这辈子 从来 没 坚强   大小 坎 都 死 撑过去   
 磕7达人: 张颜齐 0702 生日快乐   hzjj 都 好     真的 拖后腿 dbq 
 一九sui: 撑下去 撑 七月 四号 十点 回到 宿舍 睡 下午 好累 好怕 脑子 不转   
 小黑呀·: 月 低谷 期来   莫名其妙 失落   莫名其妙 想 哭   手机 不 做些   不   没什么 信心 到底 还 撑下去   跪球   赶紧   周五 快点 到来   
 Lucky又在做梦了: 害 ！ 七月 都 搞 cp 快快乐乐 磕糖 暑假 夏日 限定   
 邢佳栋今天营业了吗: 生日快乐 ！ 记得 营业 ～ 
 盒洛洛落地不成盒: 撑下去 加油 明天 晚上 凤凰 不 恩施   
 杨漂漂TT: 承认 我过 一点 不好 很多 真的 都 熬 不   快要 崩溃 不 压力 改变 都 太 好多 事情 真的 接受 不了   无力 抗拒 只能 哭 完 再 爬起来 老老实实 走 这辈子 从来 没 坚强 大小 坎 都 死 撑过去     2 兰州   
 小秋天和阿白: 太 快乐 
 二木木易: 撑不下去 心情 烦躁 迷茫 就读 一遍   1 清醒 时 做事 糊涂 时 读书 大怒 时 睡觉 独处 时 思考 2 再 难 再 好 淡泊 再 差 再 节省 3 路 不必 别人 标准 框定 人生 4 才华 撑 不起 野心 时       展开 全文 c 
 碎碎念的瓶: 妈妈 想 留在 家 却 一口 否决 安稳 生活 样子 大概 不 排斥 想 看 外面 世界 真的 撑不下去 再 回家 还 年轻 容错 成本低 再 努力 真的 努力   
 专属烹饪记录: 人 这辈子 都 原生 家庭 伤害 人 带给 伤疤 作 斗争 很 想 善良 大度 快乐 喜欢 大度 人 对不起 真的 再也 做 不到 努力 带 面具   
 小嚯嘿: 15.22   他来 ！ 考完试 诶 16.22   打了个 好大 哈欠 侧 趴下去 哈哈哈 好 可爱 16.38   撑不住 正 趴下去   脑袋 胳膊 上 动来动去 调整 姿势   毛绒绒 好 可爱 嗷 猜猜 睡 几点 ( 心理学 研究 方法 好难 背   知识 不进 脑子 ( ( 才 走神 观察   真的 背 不 进去 昂   
 ·天天吃糖·: 别搞 cp 回忆 专用 小 马甲 : 想要 快乐     花泽 美美 : 好好 赚钱 ！ 别想 没   M 大王 巡山 : 想要 都 拥有 得不到 都 释怀 苍南 派 : 快乐 工作 快乐 生活 雨 玲玲 zjl : 愿 努力 不负 期望 ali _ thin : 求 减肥 Tiger 公子 : 再 生病 
 幸福小四毛: 弟弟 实在 太 懂事 同学 去 上海 找 工作 碰到 中介 骗 400 块钱 钱交 工作 没想到 一进 宿舍 傻眼 墙 黑 吓人 返潮 10 几个 人 打着 地铺 只能 找 工作 跑 上海 无数个 区 选择 去 芜湖 实在 没钱 撑不下去 爸爸妈妈 说 还       展开 全文 c 
 PSYCHO喵言喵语: 熬夜 M 大王 巡山 : 想要 都 拥有 得不到 都 释怀 苍南 派 : 快乐 工作 快乐 生活 雨 玲玲 zjl : 愿 努力 不负 期望 ali _ thin : 求 减肥 Tiger 公子 : 再 生病 
 菁菁脸尖尖: 不 说     接二连三 打击 节骨眼 上 发生 不 撑下去     马上 三点     明天 大物 考试       心崩崩 跳 很 难 去 控制     害怕     真的 害怕       事情 一两周 发生       真的 感觉 疯       孤儿 还 找     还 想 做 ？         发生 事       展开 全文 c 
 Tung今天去图书馆了吗: 反射弧 很长   真的 2019 年 小羊 爱 吃 酱 肘子 : 想要 爱 朋友 都 好好 ！ 回忆 专用 小 马甲 : 想要 快乐     花泽 美美 : 好好 赚钱 ！ 别想 没   M 大王 巡山 : 想要 都 拥有 得不到 都 释怀 苍南 派 : 快乐 工作 快乐 生活 ali _ thin : 求 减肥 Tiger 公子 : 再 生病 
 ·鱼巷猫归: 今晚 一条   撑不下去 睡   翟潇闻 晚安 R1SE - 翟潇闻   
 啪叽咚咚: 撑不下去 撑 心疼 好 没 人 体会 痛苦 好好 一点 我求 
 弟弟可真可爱呐: 周年 快乐 锤 锤 
 今天真是太可爱了: 生日快乐   温柔 
 Wwwkb-3-: 平安 健康 开心 小羊 爱 吃 酱 肘子 : 想要 爱 朋友 都 好好 ！ 回忆 专用 小 马甲 : 想要 快乐     花泽 美美 : 好好 赚钱 ！ 别想 没   M 大王 巡山 : 想要 都 拥有 得不到 都 释怀 苍南 派 : 快乐 工作 快乐 生活 ali _ thin : 求 减肥 Tiger 公子 : 再 生病 
 九八不动产周刊: 经济型 可靠性 低噪音 三个 都 不 协和 撑不下去 京畿 盗图 大 魔王 : 边境 计划 firefly : 有钱赚 麻 
 奶饼加盐: 最最 最 珍贵 宝贝   李泰容 _ TaeYongBar :  李泰容     李泰容 0701 生日快乐   心中 最 珍贵 泰容 生日快乐   事情 都 做 很 好 泰容 拥有 精致 相貌 、 实力 更是 优秀 无比 全能 ACE 心中 柔软 小猫咪   陪伴 泰容 、 给予 泰容 最 最 爱 
 TheresNoSuchThing: 天涯若比邻 believetree   生辰 快乐 ！   
 Xback_lihua: 转发 微博 
 朝凪雪: 心操 人 使 0701 生日快乐   心操 生日快乐 ！ ！ ！ ！ 
 甘娣-: 小时候 总 大人 手机 真好 拿到 姐 剩下 小灵通 感觉 很 快乐 小灵通 感觉 大人 如今 买手机 买 神仙 水 买 想要 东西 却 怀念 小时候 无忧无虑 大人 小时候 心心念念 那种 大人 得不到 永远 骚动 小时候 想       展开 全文 c 
 sunny8065_655_145: 百事 纯净水 改用 铝罐  朴灿烈  边伯贤 [ SMTOWN ] 18.09 24 推特 更新 灿烈伯贤 相关 中秋节 快乐 42 秒 处   
 用户6847936819: 诊断 出患 癌症 医院 天 台上 自杀 劝 哭 说 : 医生 都 说 康复 几率 微乎其微 不想 将来 病重 受苦 亲人 撑不下去 ！ 我爱你 放弃 ！   
 今日为你而生: 感觉 撑不下去 辞职 辞不掉 死 死 唯一 快乐 事情 都 不 快乐   
 失落了的影子-: 宣酒 6 上市 热销 一周年   一周年 快乐 ！ 祝 越来越 好 ！ 爱旧 厌 威廉 古堡 夜 诗心 鹿哈 
 兜兜Cyan: 党员 节日快乐 Saori1994 : 节日快乐 
 L1-alone: 宝贝 上半年 已 结束 发生 事情 开心 难过 下半年 肯定 都 会 开心 快乐 下半年 失望 难过 伤心 我爱你   2 武汉 · 鹏程 花园   
 显富l5: 总有 撑不下去 不想 回头   
 Ix义各4_d: 祝全 天下 爸爸 节日快乐 自私 一点 希望 爸爸     爱 人 爸爸   双倍 快乐 都 快乐   
 Mxxxxx777: 路口 选择 方向     至此 再也不会 见     疯狂   可笑   快乐   匆忙 日子 回忆 都 带 滤镜   十七八岁 到底 想 忙     二十五岁 循规蹈矩 生活 会 想   一代人 终将 老去   总 有人 年轻 （ 刺猬 牛 逼 ）   
 灰色的时间521: 人生 百味 离合悲欢 苦笑 泪水 都 经历 一种 人生 一种 生活 一种 选择 里 都 多令 想象 不到 痛苦 无奈 难过 难是 难 总会 只管 努力 剩下 交给 时间 撑下去 ！ 结束 意味着 新 ！ 2019.7 1   2 北京   
 Gynnn君_: 国内 音乐剧 高贵 人 发展 不 不 公司 赔钱 做剧 撑不下去 暴躁 过气 选手 : naccifuckyouall : 晕 满嘴 自诩 高贵 恶臭 熏得 一个 激灵 竟然 高贵 人 看 音乐剧 三生有幸 
 奶油草莓的id: 文振刚 462 天   想 说   时间 真的 很快   大多 时间 都 异地   经历 很多   都 对方 改变 很多   陪 撑过 很多 不 开心 难熬 日子   日子 好好 走   
 偷电瓶车养你呀呀呀呀: 全世界 xdcy 生日快乐 ！ ！ （ 超 大声 生日礼物 为宁 演唱 一首 星星 点灯 心动 超元   
 遇见辰拾: 人生 浑浑噩噩   一晃 上半 年   天气 天意   希望 余下 二 开头 日子 里 找到 盔甲   力量 心安   27 月 快乐   想 好好     愿 都 小可爱   
 ISEE胡萝卜: 0713 王子 异 生日快乐   舍不得 舞台 相关   王子 异 
 尤尤尤其_: 好 想 过生日 ！ 想 人 牵挂 ！ 都 充满 好听 情话 嘻嘻 ！ 蛋糕 还 甜 祝福 期望 ！ 撑不下去 盼 生日 十八 十八 ！ 晚安 ！   
 蔡長壮: 感觉 一个 深闺 怨妇 见到 不 抱怨 还 不少 相比 人 聊天 更 倾向 怼 人 骂人 想 吐 槽 一天天 上课 课 内容 大于 意义 可过 这阵儿 意义 大于 内容 第二次 重来 那种 感觉 快 撑不下去   
 qi510678878: zxc668   杨浩走 悬崖 第一个 跳下去 嗵 一声 跌入 深深 河水 早 黑漆 涛 难以 视物 落水 准确 时间 猛地 沉入 水中 差点儿 便 喝 上 一口 河水 摒住 呼吸 浮出 水面 时 猛力 划水 强撑 不让 顺水 飘 太快 仰头 崖 上 大叫 石 兄弟 本帅 平安无恙 下   
 约翰尼德普颖: 感觉 撑不下去   
 狗子最愛环游: 忧愁 时想 想 冬季 想 太阳 快乐 时想 骄阳 下想 树荫 ！ 华晨 宇 yu 
 黑白冷羽: 缘来 大璐璐 : 生日快乐 
 yuanyuanyuanyuanyuan-: 吃     撑 坐 不   绝望   
 都市栗人xi: 生日快乐 
 七月的米巫婆: 今日 监考 同事 哭穷 说 去年 买 一套 一百八十 平 房子 后 没 钱 转瞬 说 实在 撑不下去 就让 老爹 老妈 老家 五 套房 卖 一套 好   
 汪陈同学: 粽子 节 快乐     ～ 醉人   
 时光流年桃花劫: 喜欢 一个 人 很 久 真的 会 很 累 很 累 喜欢 蔡 徐坤 却是 最 快乐 最想 事 无数 动力 努力 喜欢 一年 成长 好多 未来 期 走   
 LIEB_BEHALTEN: 玉狮安 : 梦境 循环 _ : AnneElizabethAliceLouise : 水乐 - : - 妳 謙爹 : 快乐 
 归去欢喜处:  十年 一品 温如言 时间 太快 一转眼 七月 言希 生日 生日快乐 言 ！ 年 年 悠长 岁 岁 平安 ！   
 養貓記事簿: 有时候 会 想着         广义 上       快乐 好了吧 会 快乐     想要 更   都 会   宝贝   美好 都     这么久   放弃   
 小绵龙的麻麻YanRAD: 初恋 追星 没想 初恋 不 进来 实际上 错过 苦撑 时期 越 越 喜欢 、 越 回顾 越 坚定 办法 ？ 只能 庆幸 走 
 妳是我唯一想要的了解-: 生活 困苦 想 都 撑过来 走 K 双 门洞 惠化 洞 （ 口琴 版 ） （ Cover 请 回答 1988 ）   ( 网易 云 音乐 )   
 跛腿狼先生: 首都儿科研究所   东家 生日快乐 ！ 
 4wwant-: 利特 0701 生日快乐 
 侯猫妖: 离别 坏 事情 使 更 深刻 记住 拥有 关系 使 下次 再见面 理由 离别 使 期待 伤感 快乐 多一些 美好 定格 住 才 离别 意义   
 潘小胖要天天开心: 过不下去     车该 开   喜欢 摄影 学   工作 撑   ...... 着急 慢慢来   着急   慢慢来 着急   慢慢来 想要 都 会   
 蘑菇爷爷的老花镜: 做做 小孩 做 小孩 希望 坚强 很多很多 很多 耐心 无限 耐心 撑不下去 希望 包容   
 赵华奎: 林青霞 18 岁 二女儿 ## 孟美岐 1015 生日快乐 孟美岐 : 开心 露牙 笑 都 不 偶像 包袱 事儿 ！   
 樂活的女人: zxc668   男人 唯唯喏喏 不吭声 妇人 叹 口气 道 放心 一日 夫妻 百日 恩 瘫 瘸 都 抛下 一个 妇人 这家 撑不下去 女人 说 说 呜呜 哭泣 男人 长长地 叹息 一声 道 小东 别哭 对不起 那心 留下 ？   
 药川: 106 抽无事 发生 本该 快乐 抽卡   
 有券君: 19.9 入   雅集     玻璃杯 子     办公室 茶杯 - - - - - - 昨天 种草 推荐 测评 事 失败 李遇 春 商量 都 这阵子 先 跟着 少东主 安心 做买卖 待和裕升 实在 撑不下去 再 想法子   
 大方grunt: R1SE - 姚琛 :  R1SE                     入住 新 家 快乐 ～     10 年   20 年   30 年 R1SE Family       Together   Forever           
 芸儿44048: 承认 我过 一点 不好 很多 真的 都 熬 不   快要 崩溃 不 压力 改变 都 太 好多 事情 真的 接受 不了   无力 抗拒 只能 哭 完 再 爬起来 老老实实 走 这辈子 从来 没 坚强 大小 坎 都 死 撑过去     2 江门   
 我喜欢所以你喜欢: 想 说 长大 好多 烦恼 小时候 开心 话到嘴边 憋 回去 天天 都 吃苦 小时候 很 艰难 时刻 小时候 小口 小口 吃苦 长大 张大嘴 吃 承受 苦 能力 变强 才 会 捧 开心 大笑 吃苦 哪有 尽头 苦尽甘来 撑不下去 力气 向前 看 倒霉       展开 全文 c 
 敷衍的yan鯽: 旅途 
 用户6847857933: - 人生 撑不下去 死皮赖脸 挺 一阵子 好像   
 berryVanilla: 生日快乐 ！ 
 夏洛特之梦: 金 掌勺 11 岁   生日快乐 萌萌 喵 V5 
 时暮皆为卿:  易 烊 千玺 七月 滴 好运 快乐 都 TFBOYS - 易 烊 千玺   
 用户6847670267: 「 真的 撑不下去 」 啜泣 脸 埋进 双手 拍 肩膀 鼓励 「 撑下去 ！ 难道 忘 时 我俩 许下 誓言 ？ 300 一个 人 自助餐 ！ 」   
 一只萌omen: 珍惜 拥有 快乐 生活 来之不易 永远 感恩   
 冰阔落味嘴唇的美少女: 今晚 一顿 真的 撑不下去   
 ViolaXuHao: 撑不下去 休息 休息 ！ （ 做 梦 银行存款 你配 ？ ！ ） 妖 妖小精 : 吃 好 睡 好 天天 拉粑 粑 ～ 
 胡小悦喜欢鹿晗啊: 乐观 冷静 努力 我快 撑不下去   
 khjNz-背城一skl: " 钱 很 帮 很多 人生 梦想 人生 快乐 钱 太多 关系 希望 人 都 快乐 赚钱 玫瑰和桥: 更博太 频繁   说 开个 微博 小号   没 手机号 绑定   猿 十张 电话卡   太懒   没拿卡 绑定   真的 屁大 点 事 都 想 发个 微博   大白话   栾川 话 说 听   哈哈哈 奇葩   七月 三分钟 一个 小时   小王 祝 快快乐乐   开开心心   
 Zunnnnlier: 却 前半年 几件 事情 深夜 黄昏 自此 闭关 祝 今日 好 愿 往后 安 生日快乐   
 Xiao年轮: 撑不下去 很 幸福 谢谢   
 芸儿44048: 承认 我过 一点 不好 很多 真的 都 熬 不   快要 崩溃 不 压力 改变 都 太 好多 事情 真的 接受 不了   无力 抗拒 只能 哭 完 再 爬起来 老老实实 走 这辈子 从来 没 坚强 大小 坎 都 死 撑过去     2 江门   
 花洛墨:  兴真 晚安 党 生日 祝 亲爱 党 生日快乐 ！   
 ZL小皮孩儿咯咯咯: 拼 尽全力 努力 效果 都 不及 别人 万分之一 太 愚蠢 ？ 撑下去 好 难受 我怕 再也 阳光 想 做 不到   
 EliAuk0: 年 年 平安 岁 岁 生日快乐     
 老坛握笔培训中心: 加油 加油 加油 加油 加油 加油 加油 加油 加油 ！ ！ ！ ！ ！ 再学 一个 星期 物理 永远 不学 ！ ！ ！ ！ 加油 加油 撑住 ！ ！ ！ ！ ！ ！ ！ 再有 一个 星期 离开 地方 ！ ！ ！ ！ ！ 做 喜欢 事情 见 想见 人 ！ ！ ！ ！ 撑下去 ！ ！ ！ ！ ！ ！ ！ ！   
 林子薇薇V: 很快 就要 撑不下去   
 一粒牛奶_: 七月份 一粒 還要 繼續 快樂 [ 太陽 ]   
 Cececelia_: 两天 心态 真的 一点 爆炸 一点 受不了 生活 上 周末 班好 不 值得 想想 不值 再 一点 动力 都 信念 支撑 好 累 还要 撑 三个 月 才能 熬 到头 两个 月 不到 一点 计划 都 提前 考 多天 压力 一下子 涌上来 才 好 崩       展开 全文 c 
 宋城希CheneySong: 算算 這是 第四次 參加   越野跑 第三次 參加 25 公里 首次 挑戰 15.7 公里 獻給 merrell   水返 腳 兩棲 越野跑     很 幸運 都 平安 順利 完賽     ( 當然 受點傷 對 來 說 都 ) 兩年 後 回到 起點 這次 選擇 征戰   25.7 公里               老實 說 從 來 沒想過 我會       展开 全文 c 
 繁华6143121420:  晚安 语录 人 独自 前行 任何人 都 帮不上忙 再苦 再 难 撑下去 有时候 真的 想象 还要 强大 微博 贴纸   
 ___白石医生的抹茶pocky: 火箭 少女 101 _ 傅菁   小宝 你养   撑不下去   
 出国劳务平台: 人生 百味 离合悲欢 苦笑 泪水 都 经历 一种 人生 一种 生活 一种 选择 里 都 多令 想象 不到 痛苦 无奈 难过 难是 难 总会 只管 努力 剩下 交给 时间 撑下去 ！   
 法克low逼们: 吃 吃 大 面包 分 三次 吃 居然 一口气 两次 吃 完 撑 脚板 早上 不爽 压下去 难受 走路 多压 几下 舒服 点 保健 保健 买 神灯 天天 在家 热敷 按摩 膏   
 乔啊家啊乐啊:  zinco 泥鳅 祝渣 男 朱 建党 生日快乐 感动 中国   泥鳅 zinco   
 晴雨剑: 压力 无形中 越来越 紧 本来 撑住 一件 小事 爆发 ！ 心情 不爽 到极点 ！ 刚刚 居然 宿舍 设备 极度 匮乏 情况 下 马桶 整通 好像 事 都 豁然开朗 ！ 难受 过不去 坎 马上 就要 成功 前 障碍 期待 事 努力下去 肯定 会 好 ！       展开 全文 c 
 valeriantaker: 周末 看 两天 书   昨天晚上 撑不下去 十点 睡   定 6 点 闹钟   没 每节课 阅读 量 电脑 上 死 都 看 不 进书 习惯   明年 选 课会 死   九月 回来 还 再 研究 研究 课     
 渊夂: 我快 撑不下去   
 serendipity0506: 去 拉面 店     份量 价钱 正比 21 吃 一半 吃 不   .... 撑   
 阿毛的咸奶盖儿: 胡思乱想   快乐 灵丹妙药   
 北极熊要吃我的企鹅宝宝: 睡个 好觉 北极熊 吃 企鹅 宝宝 :   希望 不用 太忙 闲下来 开心 小羊 爱 吃 酱 肘子 : 想要 爱 朋友 都 好好 ！ 回忆 专用 小 马甲 : 想要 快乐 花泽 美美 : 好好 赚钱 ！ 别想 没   M 大王 巡山 : 想要 都 拥有 得不到 都 释怀 苍南 派 : 快乐 工作 快乐 生活 
 娟wengyujuan: 、 少 发脾气       、 按时 睡觉   、 乱 想 、 、 笑笑           我愿 你好 眠 七月 快乐 ～ 晚安         夜猫子   
 奇思妙想呆毛: 家 心灵 港湾 这句 话 字面 理解 一个 人 原生 家庭 独立 欲望 日后 会 独立 孩子 之间 最 融洽 相处 关系 不 涉及 利益 孩子 在外 打拼 再苦 再 累 绝不 父母 积蓄 度日 实在 撑不下去 回家 家人 想想 向往 生活 hp 满格 振作精神 父母 孩子 操心 却       展开 全文 c 
 奶思晁: 哥哥 生日快乐 ！ ！ 耿浩伦 real   希望 明天 商法 考试成绩 哥哥 身材 好   
 跨越时间之海: 折磨 一点 都 不 快乐   
 记录无聊的日常: 放下 外 物 活 开心 一点 感觉 我快 撑不下去 假装 开心 真的 很累 没人 懂 很 累 感觉 一个 极端 陷入 一个 极端 亲情 、 友情 、 爱情 都 不在乎 好   
 穿山太保: 暂时 离职 计划 放一放 领导 两个 项目 丢 机构 老师 放 话 接 还要 安排 一个 带教 呜呜 带教 宝宝 真的 撑不下去 惹   
 叶幸运和叶小宝的故事: 换个 乐器 多事 接下来 多集 想想 片头 片尾曲 场景 撑下去 说 不 看 时 真香 他俩   锁住 毕竟 演员 拍 很 辛苦 
 好的呀好看呀: 撑不下去 只能 告诉 死 不起   
 FREEDOM平: 太 心声 太 真实   貴方 と の 時間 は   い ま や 夢 の よ う   etnw 两年 半   想到 收录 live 都 收录   疯狂 流泪   怀疑 到底 去 看 一切都是 臆想 梦 数着 能见 日子 撑下去   还 高强度 追 多久   最 喜欢 solo   live   出张 碟 求求   说 都 烦 
 鱼徉澈水: 飘 上次 好好 打超 鬼王 100 + w 撑不下去 这次 考试 周 ＋ 超 鬼王 断断续续 230w ＋ ssr 兑换 椒 图 皮肤 兑换 还 想 换 大 号 ＋ 三 小号 刷出 五   ＋ 六   超 鬼王 不到 20 只 很累 清面 佛 清面 狗 阵容 一年 不老少 明天 考 概率论 依旧 不       展开 全文 c 
 萱草杂声: 海拔 4500 米 徒步 八公里 山路 身体 不听使唤 头痛 欲裂 康巴汉子 西绒 跳 下 山坡 掰 一根 树枝 说 拐杖 真 不行 背 我能 背得动 三百斤 ... 想 倒下 没事 有人 会 背 快 撑不下去 却 想 怎能 趴下 撑 山下 人 背 下山       展开 全文 c 
 大连食品清关_287: 世界 上 缺少 快乐 缺少 寻找 快乐 眼睛   
 有一个院子的旺旺呀: M 大王 巡山 : 都 极富 年代 感 照片 好 棒 最纯 笑 最美 童年 最 真的 成长 江南 大 野花 :   纯真 笑脸 快乐 童年 特别 几个 小朋友 长大 后举 当年 照片 感动 青 艸 堂 : 這 篇文章 特別 採訪 36 年 後 找到 「 小朋友 們 」 感謝 每日 人物 用心 ！ 
 blackwhite__whai: 不认 怂 没 办法 撂倒 我要 加油 撑下去 忍住 上司 神经病 
 Anna玉儿: 都 坚持下去 理由 
 只有大脸: - ShineWu   撑 吃 不 饼 
 晓玲200509: 六月 太阳 很烈 空气 中 飘过 一阵一阵 夹杂着 汗臭味 热风 晓月 傻傻的 站 学校 操场上 太阳 火炉 炙烤 脸上 滚落 不 汗水 泪水 神情恍惚 快 撑不下去 倔强 不   2 广州   
 钱叨叨-: 7 月 1 号   7 月 毕业 后 真的 离开 学校 第一个 月   7 月 头   很 忙   铁人 钱 不吃 不 喝   调整 好 心态 真的 会 很   感觉 不 念叨 再撑 真的 会 撑下去   喜欢 身边 朋友   爱   
 等我长大了妈妈就把我嫁给你啦: 累   撑不下去   
 氟西汀Fluoxetine__: 真的 撑不下去 头疼 好 几天 熬夜 昨天 通宵 考试 都 后天 护导 书 依旧 白白胖胖 我该 好 想 回家 我要 不行   
 毛毛虫WAN: " 浙大 博士 跳江 自杀 :   孩子 图图有点怪: 快 撑不下去   
 幻想让生佛更美腻: 老天 帮帮我 真的 帮帮我 感觉 快 撑不下去   
 泡泡君鸭: 带来 快乐 选择 好好 工作       好好 蹦迪 夜 还 熬     2 郑州   
 活在淡水里的咸鱼: 绝美 嗓音 绵羊 0318 : 学不 这歌 撑 太绝 感叹 梨 阿琳 : 不醉 死 声音 里   ♀ 
 _烂人也想拥有好运: 利特 0701 生日快乐   大 哥哥 生日快乐 
 妈粉扛把子: 受不了 受不了 就算 俩 男主 都 撑 不下 看 ！ ！ 问 一句 剧版 温情 去 死 ？ ？ ？ ？ ？ 
 软软小懒: 粉上 半年 经历 很多 心累 会 想着 不 感觉 撑不下去 依旧 真的 放不下 喜欢 依旧 想 看着 依旧 舍不得 想 会 静静的 等待 默默 背后 做些 力所能及 事情 时光 不语 静待 花开   
 冰镇西柚蝙蝠派: 热 搜去 看 些 恋爱 剧 好几部 第一集 都 撑不下去 无论是 校园剧 校园 延伸 职场 剧 一部 剧 男主 调换 违和感 都 一个 模板 纸片 人 真实 口区 电视剧 市场   
 Bevshyu-: 求求 认真学习   好好 努力   真的 再 玩 吃 真的 很肥 开心 呜呜 再 难 加油 撑下去 M 大王 巡山 : 想要 都 拥有 得不到 都 释怀 苍南 派 : 快乐 工作 快乐 生活 雨 玲玲 zjl : 愿 努力 不负 期望 ali _ thin : 求 减肥 Tiger 公子 : 再 生病 
 皓月呐呐: 一岁 生日快乐   ！ ！ ！ 昨天 说 好好 珍惜 零岁 大姑娘 妈妈 谈恋爱 寿星 考完试 带 耍 呐 八年 十月底 私有 陪 度过 沉沦 岁月 想过 会 自由 生活 质量 会 好 丑 丑       展开 全文 c 
 小__小耳朵诸出世: 宣酒 6 上市 热销 一周年     有生 日 快乐 ！ 洪 仦 辰 想 都 梦 硪 們 铱 植狠 哖 請 
 Cmdr_29: 真的 打电话 祝 节日快乐 ... 还好   有没有 好好 吃饭   祝 节日快乐 节日快乐 对不起 ...........   
 jttlalm: 大王 保佑 七月 第一周 下周 过得 顺顺利利 开开心心 快快乐乐 幸福 甜蜜 ！ 保佑 工作 少 点 烦心事 少 点 人和事 找茬 挑刺 ！ 保佑 男朋友 感情 稳定 越来越 好 越来越 幸福 甜蜜 ！ 保佑 约会 见面 腻在一起 ！     
 逍遥小猫酱: 昨晚 篇文章 单位 团购 蛋糕店 撤店 南京 最 热闹 中心 俗称 暴利行业 蛋糕店 做 不 想起 团购 时 问及 店长 上 一个 蛋糕店 为啥 撤走 说 生意 难 做 说 估计 撑 多久 说 十年 没 两年 跑 原因 依旧 生意 难 做 ！ 房租 付不起 ！   
 夏月婵歌_368:  夏目 友人 帐 宝宝 少女 心   温柔 夏目 生日快乐 
 Vx_利刃: 凌晨 两点 回到 宿舍 早上 睁开 双眼 听课 这是 一段 痛苦 日子 室友 一句 话 惊醒 单位 纯粹 时间 也许 都 抱怨 过累 内心 痛 快乐 解除 羁绊 专心 一件 事 多么 美好 日子 如同 现闻 清香 缓缓 入眠   
 佳Fung: 晋晋 妈妈 有话 想 说 妈妈 最 喜欢 笑 妈妈 不 舍得 流眼泪   愿 多一分 快乐   少 一分 悲伤   妈妈 永远都是 最 可靠 港湾 妈妈 爱     2 佛山   
 妙木山山民:  进击 巨人 第三季 part2 结束 海 真相 、 代价 依旧 血淋淋 残酷 世界 残酷 美好 残酷 永远 都 美好 会 珍惜 美好 ？ 人 不 沉醉于 东西 估计 都 撑不下去 找到 沉醉 东西 ？   
 无情的红烧肉198311: 水深火热 考试 周 一天天 熬 怀疑 我能 撑 考完试 那天   
 用户6847857933: - 人生 撑不下去 死皮赖脸 挺 一阵子 好像   
 unhappygoose: 脚 踩 体制 内 拳打 流量 圈   出国 唱 跑调 海外 无人 晓   出圈 全靠 假唱 逼格全 凭粉 吹   原创 想出 好剧 还 跨界 撑场   借沪圈 雄心豹胆 编不 反正 小鹅 不   
 aaaa_千: 粉丝 感情 纯粹 少 一分 不行 多一分 越界 追星 很 快乐 ！ 少 一点 真情实感 ！ 事情 不想 再 经历 第二遍   
 Charon527-: 快乐   开心   勇敢   温柔   坚强   宠爱   
 甜甜荃儿: 终于 结束 一个月 学习   想想 前 几天 累 委屈   好像 好久好久   撑不下去 努力   天生 乐观   只不过 强迫 咬咬牙   早上 吃 不了 饭 只能 啃着 昨晚 面包   最 难过   好多 人 理解 不了 难 说 活不下去 转 锦鲤   背书         展开 全文 c 
 伱的烟熏到我没关系: 噫 看 迪士尼 好 快乐 
 BEST_DZR: 希望 撑不下去 再 再 尽力 一刻 会 超乎 想象 永远 放弃 一刻   
 就是张小玲: 重庆 高估 肚量 一碗 小面 三碗 冰粉 一顿 火锅 吃 撑 还 计划 吃 一路 吃 不 洪 崖洞 新建 很多 商场 两年 前 记忆 中 街景 不   唯一 一个 来过 第二次 城市 十五天 行程 满满的 旅行 结束 回家 睡觉 去     
 愛笑的眼睛elaine仙: 《 一首 urban   R & B 曲风 重 节奏 情歌 歌词 叙述 一段 爱情 走 尽头 甜蜜 只 剩 回忆 真爱 时间 蚕食鲸吞 还 存留 一丝 希望 愿不愿意 这份 爱 撑下去 ？ CoCo 歌声 抚慰 痴心人 心情 希望 感情 僵局 时 懂得 珍惜   
 为什么矶井实光这么好味: 艺术 生 上课 时间 都 很 随缘 本人 没什么 睡眠 都 乱 睡觉 [ ] 真的 想 调整 睡眠 时间 伞教 通宵 熬 一段 时间 倒 再 时间 醒过来 熬 实在 撑不住 条件 睡个 一两 小时 打个 盹 不 影响   
 xx就要多读书-: 还 掉色     滤镜 撑不下去     不 ！ 搞 ！ 丑 ！ ！ 开光 佛珠 _   : 成功 教育 一胖毁 
 夏小末嘚小屋: 不 30 年 活 撑不下去   2 晋中   
 仙女觉得人间太险恶: 喝 三杯 咖啡 一罐 红牛 我要 撑不下去   
 余枣枣-: 六月 做 喜欢 一贯 坦荡 毫不在乎     称不上 顾虑 烦恼     轻松     自由     快乐 七月 愿望 愿 六月 许 愿     如愿 诸事 顺遂 特别 希望 家人 朋友   朋友 家人   身边 人   平安   喜乐   
 devasu: 买 宠物用品 都 希望 宠物 快乐 舒适 宠物用品 隐患 反而 会 导致 爱宠 生命危险   
 zGbSE-交战国mwd: 快乐 思想 会 快乐 ； 凄惨 思想 会 凄惨   
 银鱼儿煎蛋: 加倍努力 ！ ！ ！ ！ 回忆 专用 小 马甲 : 想要 快乐     花泽 美美 : 好好 赚钱 ！ 别想 没   M 大王 巡山 : 想要 都 拥有 得不到 都 释怀 苍南 派 : 快乐 工作 快乐 生活 雨 玲玲 zjl : 愿 努力 不负 期望 ali _ thin : 求 减肥 Tiger 公子 : 再 生病 
 琪敏周敏琪: 好累 好 累   精疲力尽 快要 撑不下去 转念 一想 说声 加油 ！ 希望 明天 ！   
 今tia也没瘦: 人   祝 麻薯 宝 生日快乐 ！ 两岁   余下 鼠 生里 吃 饱饱 睡 好好 （ 图为 1 岁 时   
 关于200306: 0416 生日快乐 庞嘉 我见 很多很多 行人 看过 很美 很 美的 风景 却 一个 人能 拨动 涟漪 说 长得 好看 说 唱歌 不好 听 却 带给 惊鸿一瞥 愿为 守 远方 并肩 前行 爱   
 愛笑的眼睛elaine仙: 《 一首 urban   R & B 曲风 重 节奏 情歌 歌词 叙述 一段 爱情 走 尽头 甜蜜 只 剩 回忆 真爱 时间 蚕食鲸吞 还 存留 一丝 希望 愿不愿意 这份 爱 撑下去 ？ CoCo 歌声 抚慰 痴心人 心情 希望 感情 僵局 时 懂得 珍惜   
 啊睿啊Aria: 每次 压力 大到 撑不下去 发 一发 wyj 丑照 舒服 ！   ！   
 成长pgjm: 睡醒   都 感觉 深深 绝望   都 撑不下去   咬着牙 完       2 海口   
 clairesharo: 感谢 认可   ～ 快乐   
 帅气机智哒浴帽超人酱: ？ 真的 撑不下去 委屈 要命 当初 分配 这项 工作 本来 超出 能力 明明 是因为 人 去 做 去 做 才 会 分配 没法 拒绝 想 学习 提升 不 这项 工作 高 精细 只用 做 一件 事       展开 全文 c 
 一派秋声_: 惹 不知不觉 半年 好像 都 没 做 五月 追星 搞创 真滴 很 快乐 再有 一周 放假 回家 前 第一次 去 博物馆 值班 紧张 讲解 词忘得 差不多 去一趟 北京 去一趟 上海 不 有没有 时间 去 江西 （ 没   ） 真好   
 要你向我飛奔而來: 拒绝 别人   别人 就算 是因为 喜欢 撑 半个 月   成 定律   别人 长久 走   习惯   
 -Sherlockkkk: 我球球 西兰花 赶紧 出 BDCDDVD 行不行 只靠 前三刷 记忆 我快 撑不下去 
 正宗糖丝儿: 一块 善良 苛性钠   生日快乐       十年 余生   
 用户5a6igx467j:  鹿晗 鹿晗 0420 生日快乐 ## 鹿晗 上海 堡垒 早安 鹿饭 早安 打卡 — — — — — — — — 每日 签到 — — — — — — — — ★  鹿晗 超级 话题 签到   O 鹿晗 _ 百度 贴 （ 请 手动 签到 切勿 一键 签到 ） — — — — — — — — 每日 投票 — — — — — — — — ... 全文   O 网页 链接   
 郑柏旭助理贾真真: 生活 有趣 永远 不 明天 会 到来 命运 都 提前 安排 好 希望 事情 永远 发生 祈祷 永远 努力 一塌糊涂 ～ 不愿 想 太 生活 太难 太 恶心 ～ 不 面对 还 ！ ？ 真的 撑不下去 生活 太 绝望   
 用户6713632229: 7.1 说 再 生气 情绪 都 再 跟着 走 撑不下去 不再 生气 前提 再 想着 容许 再 任性 升职 酒 参与 我怕 人 喝 交杯酒 我会 难受   
 人间小萝贝: 不想 再 失眠 ！ 一刻 ！ ！ ！ 小羊 爱 吃 酱 肘子 : 想要 爱 朋友 都 好好 ！ 回忆 专用 小 马甲 : 想要 快乐     花泽 美美 : 好好 赚钱 ！ 别想 没   M 大王 巡山 : 想要 都 拥有 得不到 都 释怀 苍南 派 : 快乐 工作 快乐 生活 ali _ thin : 求 减肥 Tiger 公子 : 再 生病 
 mmayan丨p_750: 做 一个 温暖 人 不 求 大富大贵 只求 生活 简单 快乐   
 用户6847326430: 诊断 出患 癌症 医院 天 台上 自杀 劝 哭 说 : 医生 都 说 康复 几率 微乎其微 不想 将来 病重 受苦 亲人 撑不下去 ！ 我爱你 放弃 ！   
 行走的大白白: 撑不下去 撑   
 我爱生活生活爱我yeah: 生日快乐 
 Cy_Tuzki_D: 加完 班才 发现 6 月 翻篇 祝福 日常 林宥 嘉 YogaLin   生日快乐       
 红了樱桃汁: 没 : 笑 死 今日 份 快乐 源泉 朋友 奇葩 : 哈哈哈哈 哈哈哈哈 今晚 睡不着 人字拖 大 魔王 : 还 没点 开 腾叔恰 shi 渣 蜀黍 : 李光洙 哈哈哈哈 艹 哈哈哈 张奶霞 : 哈哈哈哈 哈哈哈哈 衣服 都 撕 文科班 校花 酱 : 金钟国 好 可怜 样子 上房 揭瓦摘 星星 : 哈哈哈 哈哈哈 小猪 太逗 
 Dl8whyy: 不想 再 拥有 墙头 想要 平常 持续 追星 不 想要 社交 有时候 人 说话 面孔 太多 不 撑下去 原以为 父母 身边 父母 中 top 前五 很 开明 那种 父母 被迫 发现 免不了 俗套 质疑 很 害怕 坏 情绪 自我 厌恶 缠 上身 做 一个 很 勇敢       展开 全文 c 
 little-papa: 好 心情 ！ 健康 ！ 顺利 ！ 回忆 专用 小 马甲 : 想要 快乐     花泽 美美 : 好好 赚钱 ！ 别想 没   M 大王 巡山 : 想要 都 拥有 得不到 都 释怀 苍南 派 : 快乐 工作 快乐 生活 雨 玲玲 zjl : 愿 努力 不负 期望 ali _ thin : 求 减肥 Tiger 公子 : 再 生病 
 不懂黑泡的pengihye: 李泰容 0701 生日快乐     黎明 光辉 李泰容   生日快乐   宝贝 
 Tiger彬彬: 承认 我过 一点 不好 很多 真的 都 熬 不   快要 崩溃 不 压力 改变 都 太 好多 事情 真的 接受 不了   无力 抗拒 只能 哭 完 再 爬起来 走 这辈子 从来 没 坚强 大小 坎 都 死 撑过去       加油   
 MiaoKingg: 好累 撑不下去   
 用户6846078303: 约 吃 甜品 看 电影 始终 进一步 动作 连好 几次 碰到 手 都 牵 天下 小雨 撑 伞 散步 想 笨蛋 不 主动 ？ 路过 小桥 时 折起 伞 扔 河水 里 愣住 笑 说 一个 人 淋雨 恍然大悟 咻 一声 伞 扔下去   
 Motif米田: 老朋友 感谢 陪伴 三两 合欢 :   用过 湖畔 模式 很 舒服 下架 零星 导出来 数据 忘 用米 田 真的 换 手机 必备 app app 苹果 手机 定期 上线 刷 更新 看遍 开发人员 介绍 担心 运行 会 将来 撑不下去 还 发过 信息 感谢 辛苦 加油 
 Deadend0714:  抑郁症   撑不下去   
 _WekiNaNa_: 傻帽 孩子 脸   创意 真的 弄 不 SixYeDam : 放心 创意 都 是因为 帽家 孩子 脸 撑起来 
 falltopieces: 不 换 手机 理由 重新安装 APP 实在 太 痛苦 压根 不 记得 密码 微博换 手机 理由 太多 都 不值一提 一个 值得一提 都 重新安装 爱奇艺 看 乐队 夏天 怕 存储 满 手机 死机 值得一提 再 撑下去   
 一个身体只能有一个灵魂: 不 还 熬 多久 不 撑下去 ？   
 BOICE_Ho: ！ 撑不下去         
 杨小轩6047275680: 持家 老铁     生活 压力 好大 手机 7 年   感觉 我快 撑不下去 
 栗十八呀: 离别 太多 许个 朴实 愿望 希望 都 快乐   
 苡婕_: 经历 都 财富 点到为止 主动 恰到好处 距离 适可而止 悲伤 提起 回望 停步 不 前 人生 经历 一部分 最 想 去 留住 那份 时光 顾虑     注定 过得 不 快乐 删除 键       确实 最 幼稚 按钮 洒脱 人生     起放 下 余生 很 幸福   
 ___白石医生的抹茶pocky: 火箭 少女 101 _ 傅菁   小宝 你养   撑不下去   
 用户6964176888: 撑下去 责任 未 完 不 想 不如归去 ！   
 尤尤尤其_: 好 想 过生日 ！ 想 人 牵挂 ！ 都 充满 好听 情话 嘻嘻 ！ 蛋糕 还 甜 祝福 期望 ！ 撑不下去 盼 生日 十八 十八 ！ 晚安 ！   
 老坛握笔培训中心: 加油 加油 加油 加油 加油 加油 加油 加油 加油 ！ ！ ！ ！ ！ 再学 一个 星期 物理 永远 不学 ！ ！ ！ ！ 加油 加油 撑住 ！ ！ ！ ！ ！ ！ ！ 再有 一个 星期 离开 地方 ！ ！ ！ ！ ！ 做 喜欢 事情 见 想见 人 ！ ！ ！ ！ 撑下去 ！ ！ ！ ！ ！ ！ ！ ！   
 布莱斯的女孩: 真的 想到 鸡条 会 拆散   特别 难过   鸡条 唯一 真心 追 综艺   最 死撑 看 10 分钟 看不下去 
 Osmanthus_旺旺: 李汶翰   0722 生日快乐   好 东西 ！ ！ 简便 直达 UNINE _ 李汶翰   李汶翰 软糖 沙滩 
 小狮子的幼稚园_: 七月 第一天 陪 小孩 五个 月 ！ 看着 慢慢 走 爱   无 理由 偏爱 只 花钱   只想 快乐 话 空洞 想 全世界 天上 星星 都 摘 那种 哈哈哈   
 花花丸子头: 轻松 筹 爱心 接力 ！ - 才 11 岁 爸爸 撑下去 ！   -   轻松 筹   轻松 筹   爱心 人士 你们好 感谢 打开 求助信 袁子翔 11 岁 爸爸 58 岁 爸爸 总和 别人 说 儿子 缘分 浅 ...   O 网页 链接   
 Elvira潘朵拉: 从小 有人 告诉 坚强 女孩子 自强 自立 人 告诉 撑不下去 再撑 忙 看病 都 没 时间 人 工作 再 努力 loser   
 blueblueskyyy: 过程 狗血   先 试试看 ! 会 固步 不前 好 ! 这段 关系 里 撑不下去 希望 勇气 走开 希望 成长 过分 伤心 贬低 坚信 值得 爱 一个 可爱 姑娘 希望 过分 依赖       展开 全文 c 
 犬草田LMNOPQ: 好消息 快 撑不下去   
 ·樱花草莓星冰乐·: .... 孟 女士 真的 看剧 阻力 我快 撑不下去   
 脆皮肠flank002: 分享 本周 快乐 小 碎片   The   Commune   Social 几年 前 朋友 带 西班牙 餐厅 时不时 会 再 光顾 吃 brunch 喝点 酒 晚餐 都 很 惬意   
 羽墨青丝: 感觉 好像 撑不下去   
 VivienneMe: 陈情 令   不行 撑不下去 弃 Wi - Fi 潇洒不羁 少年郎 娇俏 可人 小 郎君   
 要你向我飛奔而來: 拒绝 别人   别人 就算 是因为 喜欢 撑 半个 月   成 定律   别人 长久 走   习惯   
 枭不拉屎大王: 致残 打击     信心     撑不下去   
 淞栩: 独白 明明 好听 ！ 歌词 走心 傅能 歌舞 气自华 : 傅菁 0629 生日快乐 视频 太好 哭 开头 一段 独白 我录 太 草率 反省 
 自画像3: 笑 女孩儿 生日快乐   
 EastHY_1216:  利特   朴正洙 0701 生日快乐         HAPPYLEETEUKDAY     生日快乐   永远 队长 哥哥     感谢 带 suju 走到   感谢 爱 包容   善良 柔软     说   宝 蓝海 覆盖 全世界   suju 停止 步伐           未来 走   长长 久久     亲爱 朴正洙   生日快乐   
 wbxsbywpa: 别人 睡觉   公交     怎样才能 坚持下去   好 害怕 撑不下去   
 世界末日女朋友ii: 撑不下去   道别 罪   
 听赖美云话的土味梦境:  赖美云 秃头 法棍   赖 拜个 早年 赖美云 机场 赖美云 含糖量 赖美云 风赖 美云 天天向上 赖美云 单曲 赖美云 0707 生日快乐   lmy 赖美云 天天向上   
 MiaoKingg: 好累 撑不下去   
 Klein-Blue_: 二 〇 九年 七月 快乐 
 郑柏旭助理贾真真: 生活 有趣 永远 不 明天 会 到来 命运 都 提前 安排 好 希望 事情 永远 发生 祈祷 永远 努力 一塌糊涂 ～ 不愿 想 太 生活 太难 太 恶心 ～ 不 面对 还 ！ ？ 真的 撑不下去 生活 太 绝望   
 谦虚的小孩儿17: 千万 辜负 天蝎女 孩儿 用情 深 真的 会 抑郁 ！ 快乐 背后 隐藏 悲伤 祝 早日 走   L 谦虚 小孩儿 17 秒 拍 视频   
 傲霜雪2010: 西城 SQL : 雾 霾 中服 雾 连个 撑 雨伞 人 都 木有 老婆 不 跑 去 美帝 一天天 烂 tinyfool :   穷国 无 外交 cct98912 :   俄羅斯 老板娘 : 美帝 日薄西山 雇不起 佣人 ！ 雾 霾 中 呼吸 : 撑 雨伞 人 都 木有 瞧不起 
 妖精_Kay: 妖精 _ Kay   K 走过 很长 路 反正 伴随 很 久 东西 K 身上 汲取 力量 没 再 用过 撑不住 一个个 点开 一个个 维护 运行 不 只能 见到 过往 脆弱 再也 容不下 如今 脆弱 看 暖心 APP 做 不 真的 惋惜   
 轻眸随叶: 啵 丝 啵 啵 啵 : 睡 : 消防员 撕心裂肺 哭声 还 记得 努力 猫 阶级 : 记得 女孩 跳楼 前 消防员 说 谢谢 真的 撑不下去 苦苦 挣扎 那段 黑暗 时光 里 不到 一句 抓 
 易燃装置的咚巴拉: 梨寒 : 六月 真的 快乐 伤痛 并行 小北 迎来 李必 街舞 乱 剪里 秃头 十二 争气 里 笑 开花 希望 七月 请 对崽崽好 晚安 
 用户6964176888: 撑下去 责任 未 完 不 想 不如归去 ！   
 莉柚薇甜: 治愈 系 - 夏目 友人 帐 : 0701 夏目 贵志 生日快乐   生日快乐 ！ 再 孤单 
 晶哥哥是小仙女儿51318: DXT 组合 - 林润欣   生日快乐 
 小卷顿: ！ ！ ！ ！ ！ ！ ！ 安安 生日快乐       具 大人 新 西游 姜 食堂 都 长长 久久 
 再来一杯绿茶: 不想 撑下去 好 累 感情 、 事业 、 生活 、 家庭 一个 人撑 真的 好 累 做 值得   
 须尽酒: 撑不下去 评论   都 很 爱   
 Boom_LD: zxc668   龙王 小儿子 龙云略 思忖 提议 道 爹 要知 先 休兵罢战 试试 杨浩 心意 至少 借此机会 将士 稍作 歇息 恐怕 真的 撑不下去   
 CrushOnYouJustYou:   码 周 天天向上 快乐 大本营 会 员 有没有 按天 卖 总 感觉 几个 月 就要   
 猫在撒娇: 都 撑不下去 早点 死 掉 拜托 拜托   
 要每天开心的炸鸡柳: 承诺 永远 做 不到 真的 撑不下去   
 vnnzl: 打榜 五分钟 开心 两 小时 ！ 速来 助力 尤长靖   K 一个 人 记得   亚洲 新歌 榜 夺冠 爱 榜 打榜 使 快乐 ！   
 Hyun_Chen小美: 朴正洙 队长 生日快乐 
 啵叽一口甜_: 都 限量版   浪漫 制造机   半年 快乐   爱 老虎 油   hoyue _   
 萱的王-: 想念 p3 好 皮肤   很少 长痘 满脸 闭口 痘痘 图书馆 说 再见   朝九晚 十坐 一个 星期   屁股 都 快 坐平   考试 都 撑不下去   假期 快乐   
 二点五次元涵OAO: 从来 学期 快要 完时 撑不下去 崩溃   
 陌夜紫澜: 对不起 撑不下去   2 西安 · 西安 建筑 科技 大学 华清 学院   
 来一分钱TM糖: 七月 第一天 倦   撑不下去   耗 才 十几个 号   
 爱威爱然: 承认 我过 一点 不好 很多 真的 都 熬 不   快要 崩溃 不 压力 改变 都 太 好多 事情 真的 接受 不了   无力 抗拒 只能 哭 完 再 爬起来 老老实实 走 这辈子 从来 没 坚强 大小 坎 都 死 撑过去   
 体温丁醇拥吻: 宣酒 6 上市 热销 一周年   一周年 快乐 生日 喜欢 吆 枫桦 虚伪 枯冰子 布莱尔 斑 比鹿 
 serendipity0506: 去 拉面 店     份量 价钱 正比 21 吃 一半 吃 不   .... 撑   
 stjkksbygkww: 七月   希望 做 一只 快乐 小猪 UNINE _ 胡春 杨   
 三叔炒股娶老婆: 想下 下不去 利好 撑 想 上 上 不 去 解套 跑 路 很多 也许 选择 方向 明天 会 突破 看 方向 更强 原以为 谈判 会 全场 利好 大 力度   
 肘貴蔟丶Bigbaby_J: 真的 撑不下去 算了吧   
 鹅记西多士: 忘記 不 開心 上半年   記得 快樂 快樂 快樂   
 吴冰雹:  studyaccount         高二 总算 结束 快到 期末 简直 快要 撑不下去 感觉 身体 快 支撑 不住         考完试 很多 事要 去 做 希望 高三 生活 顺利   
 Yuri_Blue: 最惨 听到 人 说 撑不下去 回来 都 好像 去 地方 称为 回来   
 Hello米小乐:   一本   有壁 够 撑下去 ！ ！ 明天 名 场面 玫瑰 吻 就要   激动 睡不着 哈哈哈哈   
 冷漠的大黄蜂: 浙大 博士 跳江 自杀 孩子 撑不下去 几张 图 ！ O 网页 链接   
 我是吃的很饱: 七月 快乐 
 空中飞舞的Jacky: 七月 快乐 资深 观众 韩梅梅 : 元气 满满 迎接 七月 明暗 __ 枫   : 七月 拿到 高中 录取 通知书     
 自自自自以为是: 再次 移除 朋友 微博 回归 树洞 所有人 当做 避风港 家 却 避风港 再 不想 做饭 桌上 家人 极为 失望 家族 极为 失望 人 变得 暴躁 骂 榜 骂 黄伟 骂 我哥 骂 在乎 朋友 凶 狠狠 地教 也许 不 正确 东西 毕竟 不 撑不下去 帮   
 Hyacinth201601: 极限 挑战 日子 都 淡淡地 淡淡地 去 快乐 忧伤   
 哀喜0813: 水深火热 不 捕获 朋友 父母 只言片语 安慰 还 再 往前走 变得 厉害 一点 有人 背后 苦苦 撑   
 wbxsbywpa: 别人 睡觉   公交     怎样才能 坚持下去   好 害怕 撑不下去   
 Benbee哩: 吃瓜 群众 CJ : 快 一年 睡 : 消防员 撕心裂肺 哭声 还 记得 努力 猫 阶级 : 记得 女孩 跳楼 前 消防员 说 谢谢 真的 撑不下去 苦苦 挣扎 那段 黑暗 时光 里 不到 一句 抓 
 花花大魔王有胡萝北: 一点 希望 辣条娘 : 怕   勇敢 一点 好 一点 M 大王 巡山 : 想要 都 拥有 得不到 都 释怀 苍南 派 : 快乐 工作 快乐 生活 雨 玲玲 zjl : 愿 努力 不负 期望 ali _ thin : 求 减肥 Tiger 公子 : 再 生病 
 土豆这么可爱你怎么可以吃: 2019.7 17 月 辣 ！ ！ ！ 回家 那天 吃 好多 拔牙 做 一点 感觉 都 去 临安 快乐 进食 暴食 t 7 月 开 一个 好头 家人 真的 好 快乐 ！ 还 想 说 留学 这条 路 后悔 不 后悔 后悔 离开 爸妈 感恩 慢慢 最 看重 家人 ！       展开 全文 c 
 Junedairy: 请 努力   放弃 改变 机会 回忆 专用 小 马甲 : 想要 快乐     花泽 美美 : 好好 赚钱 ！ 别想 没   M 大王 巡山 : 想要 都 拥有 得不到 都 释怀 苍南 派 : 快乐 工作 快乐 生活 雨 玲玲 zjl : 愿 努力 不负 期望 ali _ thin : 求 减肥 Tiger 公子 : 再 生病 
 兔儿买白菜: 天上 小雨 撑 伞 散步   想 笨蛋 不 主动 ？ 路过 小桥 时   故意 伞 扔 河水 里 愣住   笑 说 一个 人 淋雨 ？   恍然大悟 咻 一声 伞 扔下去   
 王小彦围脖: 阿雅儿 ～ 生日快乐 青春不老 不 散     
 想不到明天的明天: 每次 想 吃 东西 肚子 都 很饱 很撑 真的 饿 反倒 都 吃 不   
 阿依土鳖六公主: 很困 不停 弹出来 消息 搞 很烦 6 月份 过得 很 惨淡 一点儿 激情 动力 都 撑下去 总 请 一个 小 长假 梳理 一团乱 都 搞搞   大 环境 里 梳理 八百 遍 解决 褪黑素 快 吃 完 一瓶 顶 黑眼圈   不 还 多久         展开 全文 c 
 南冥鹿鸣: 人间 一场 大型 共情 实验 方方 土滴 每日 批话 ## 好 快乐 男滴   
 北投少年的颜粉: 祝 男 男 生日快乐 ！ 希望 翟潇闻 都 快乐 R1SE - 翟潇闻 
 蓝楠日恁毛毛: 哭 惹 北國 佳人 李春姬   : 时代 痕迹 Tiger 公子   : 純良 英俊 笑了笑   : 太 奇妙 36 年 后 比照 莫名 感动 江南 大 野花   : 纯真 笑脸 快乐 童年 青 艸 堂   : 這 篇文章 特別 採訪 36 年 後 找到 「 小朋友 們 」 
 韩畅刘芯言今天结婚了吗: 大概 策划 暑假 干什么   特别 特别 想 回家   多天 都 熬过去   剩 4 天 撑不下去   好 想 回家   
 17拾壹: 想 大概 撑不住 太久 一味 万念俱灰 大不了 楼上 跳下去 一了百了 站 九楼 阳台 树 郁郁葱葱 想 飞下去 树枝 尖锐 刺透 身体 念头 发抖 害怕 求生欲 想 活着 世人 只 矫情 拥有 健康 身体 却 不 爱惜 偏偏 浪费 生命       展开 全文 c 
 南部煎饼: 有时候 很多 事情 都 不太想 别人 说 只 想 撑 偶尔 撑不下去 稍微 自言自语 nb   
 灰色的时间521: 人生 百味 离合悲欢 苦笑 泪水 都 经历 一种 人生 一种 生活 一种 选择 里 都 多令 想象 不到 痛苦 无奈 难过 难是 难 总会 只管 努力 剩下 交给 时间 撑下去 ！ 结束 意味着 新 ！ 2019.7 1   2 北京   
 Ql四海5: 关系 真的 努 努力 撑下去 后来者 坐在 一排   真的 没关系 想 同行者 里 总要 有人 做 一名   尽力 清空 友情 世界 不让 变得复杂   努力 不去 打扰 原有 节奏   接受 吐槽 不 代表 接受 内心 鄙夷   不想 心思 放在 多余 情感   已     展       展开 全文 c 
 星星县的阿狸: 休 一周 再 上班 心情 沉重 浑浑噩噩 点数 起床 刷牙 打理 看着 乱糟糟 房间 想着 即将 面对 人和事 撑不下去 这份 工作 带给 期待 化为 逃避   
 Kkw的杨小妮儿: 累 撑不下去 视频 瞬间 充满 正 能量 王凯 kkw   眼里 全是 
 我有孤独和酒你要不要和我走: Happy   day   2019.06 29 回家 倒计时   天 超级 棒 沙滩 野炊   狼人 杀   美食 风大   都 很 完美 赶回 宿舍 做 ppt   困到 撑不下去 算   一个多月 没 好好 睡觉 晕晕乎乎   day1   2019.06 30 回家 倒计时   1 天从 拿到 通知 n 次 改版 演讲稿 ppt 一个多月 
 yue_月上柳梢头: 都 不 掉 面霜 两天 一大 坨 怀疑 撑 不到 结束   
 叶无桑: 转发 微博 
 行走的体型裤: 想发 下半年 第一天 好 七月 你好 [ 大 侦探 皮卡丘 微笑 ] 想起 还 花 打开 支付宝 看 看卡 余额 这回 真的 透支 hhhh 距离 开 工资 20 天 撑下去 体型 裤 语录   上个月 麻麻 救济 总 麻麻 救济 班上 光出 不进 吃不消       展开 全文 c 
 high_pressure_turbine: 可爱 外表 下 隐藏 : M 大王 巡山 : 都 极富 年代 感 照片 好 棒 最纯 笑 最美 童年 最 真的 成长 江南 大 野花 :   纯真 笑脸 快乐 童年 特别 几个 小朋友 长大 后举 当年 照片 感动 青 艸 堂 : 這 篇文章 特別 採訪 36 年 後 找到 「 小朋友 們 」 感謝 每日 人物 用心 ！ 
 懿丫yi呀哟: 大 早上 骂 一通 心态 崩 呜呜 工作 使 抑郁 啥时候 顺心 点儿 还 没 正式 入职 就要 撑不下去   2 杭州   
 Teresa高小亚: 夏天 却 扭过头去 看不见 理想 生活 之间 距离 不 明白 远 撑下去 K 理想 人 不 伤心   
 辞辞又困了: 想要 快乐   
 舒湈囡籽乄2_903: 宣酒 6 上市 热销 一周年   一周年 快乐 ！ 祝宣酒 大卖 涵影 物语 霜 宓 爱 咳嗽 樱月 芝花 
 与名井南恋爱中: 永远 珍贵 永远 独一无二 队长 生日快乐 真的 很 感谢 
 7柠NNN: 李泰容 0701 生日快乐 
 奶油五香炒瓜子: 新 一周 朱一龙 才能 撑下去 没关系 不 OK 旧图 够 看   
 童心未泯www: 生活 不易 奔跑 前行 路上 沉浸 日复一日 忙碌 里 全家 生计 打拼 再 辛苦 ； 一次次 快 撑不下去 偷偷 告诉 再撑 好 人 努力 打拼 才能 越 走 越顺   
 发妹儿33: 30 岁 再 买 18 岁 喜欢 东西 毫无意义   很多 事情 来日方长   我要 快乐     2 杭州 · 北干   
 祝我还是我: 远离 烦 人 旅途 会 变得 很 快乐 人生   
 Miss_贾小姐: 倍 倍 说 终将 活成 一个 故乡 人 鹿先森 乐队 充满 温暖 快乐   2 秦皇岛 · 山海关   
 我可以泡你吗-_-: 复习 快乐   我炸   狒狒 肯定 撑不下去 呜呜   
 不知名资深互联网网友在线冲浪: 朱一龙 太 好看 浓眉大眼 剑眉 星目 活过来 拢 龙 宝贝 不 营业 指望 军装 还 撑下去 朱一龙 
 是涂怡啊: 七月 快乐     2 石家庄 · 河北 美术学院   
 普通退役熬夜员楽光: 不 65 高资 资深 撑下去 五月 青枫   : 93 级 ！ 不 62 级 高资   还 撑下去 
 Fantastcy:   第五年 都 32 岁 人   18 岁 脸 ！ ！ ！ 安宰贤 0701   安宰贤 0701 生日快乐   
 技术部新员工: 不好意思 撑不下去   
 悠然_40418: 轻松 筹 爱心 接力 ！ - 行善 一种 轮回 请 救救 女儿 ！   -   轻松 筹   轻松 筹   犹豫 很 久 最终 发起 这次 求助 撑 很 久 实在 撑不下去 求助 人张 自兵 患者 小女儿 张菁 来自 湖北省 襄 ...   O 网页 链接   
 黎香: 觉醒 去 吃 火锅 ( 图一 ) 下午 蒋蓉飞 朋友 吃 火锅 ( 图二 ) 真的 太爱 吃火锅 感觉 上辈子 一盆 火锅 真的 吃 吐     好吃 吃 不了   死撑       秉承 浪费 钱 宗旨 简直 生命 吃     嘴里 反酸 水     胃里 涌动   难受 ~   
 宙仁时超: 王晨艺 孤影 游戏 直播 人生 朋友 酣畅 ； 人生 事业 从容 ； 人生 成就 自豪 ； 人生 家庭 温馨 ； 人生 爱 幸福 ； 人生 希望 奋发 ； 人生 健康 快乐 ； 人生 贫穷 奋斗 ；   
 和十二一起睡觉: 我快 撑不下去   
 我怎么这么爱狗血: 第九集 第十集 好 难看 ！ ！ ！ 配角 好尬 好尬 陈情 令   连续 发了 两个 微博来 吐 槽 撑不下去   2 苏州   
 小呆鱼儿爱吃糖LittleSun: 叶 幸运 叶 小宝 故事 : 换个 乐器 多事 接下来 多集 想想 片头 片尾曲 场景 撑下去 说 不 看 时 真香 他俩   锁住 毕竟 演员 拍 很 辛苦 
 四月荒年: 世界 样子 爱情 样子 真的 活 好 卑微 明明 段 感情 撑不下去 却 硬撑 爱 一个 字 说服 倔强 好 恨 没有勇气 放手   
 冷气团不冷: 始终认为 一个 人 很 天真 简单 活下去 必 身边 无数 人用 更 大 代价 守护 而来 — —   《 小王子 7 月 快乐   
 想飞向蓝天的鸽子cq: 回首 一望 大学 里 都 记得 军训 晚上 披 头发 说心里话 记得 大一 冬天 去 晴天 喝 奶茶   冷成 狗 回 寝室 记得 大二 回 眉山 见 家长 记得 大三 夏天 每晚 都 床上 记得 大四 难熬 那段 日子 都 爱   生日快乐         Imyuan9   
 疯癫范儿阿冬哥poi: 圈梨梨 : 右边 棒 仔 小 世界 : 早睡早起   开开心心   重联 旧友     夏目家 小 诗哥 : 家人 健康 平安   顺顺利利 苍南 派 : 快乐 工作 快乐 生活 雨 玲玲 zjl : 愿 努力 不负 期望 ali _ thin : 求 减肥 Tiger 公子 : 再 生病 
 Ming明贼爱你: 始 始终 终 脆弱 撑不下去 人 都 一个   
 盼盼盼盼dd: 好好 嘻嘻 回忆 专用 小 马甲 : 想要 快乐     花泽 美美 : 好好 赚钱 ！ 别想 没   M 大王 巡山 : 想要 都 拥有 得不到 都 释怀 苍南 派 : 快乐 工作 快乐 生活 雨 玲玲 zjl : 愿 努力 不负 期望 ali _ thin : 求 减肥 Tiger 公子 : 再 生病 
 圣凌皇太子: 生日快乐 ！ 领样 ！ 大野 十三 : 转发 微博 
 布莱斯的女孩: 真的 想到 鸡条 会 拆散   特别 难过   鸡条 唯一 真心 追 综艺   最 死撑 看 10 分钟 看不下去 
 上山小爱: 优路 14 年   最 珍贵 祝福 14 周年 生日快乐 ！ 加油 ！ 
 GucciGaga: 晚上 两点 睡着 好 辛苦 撑不下去   
 BuuuuuT___: 追寻 快乐   
 集藏月亮-: 小 郑   濒临 极限   撑   使 不至于 倒塌   姿势 维持下去   好 难受 好 委屈   
 冰淇淋泡芙真的超甜: 这家 人 都 矛盾 都 解决不了 吵架 吵架 抑郁症 抑郁症 喝酒 家暴 不知 错 生活 毫无 盼头 真的 想 哭 糟糕 情绪 我该 撑下去   
 小晶晶要认真了: 万事 胜意 回忆 专用 小 马甲 : 想要 快乐     花泽 美美 : 好好 赚钱 ！ 别想 没   M 大王 巡山 : 想要 都 拥有 得不到 都 释怀 苍南 派 : 快乐 工作 快乐 生活 雨 玲玲 zjl : 愿 努力 不负 期望 ali _ thin : 求 减肥 Tiger 公子 : 再 生病 
 一只萌y: 自省 不满 不 应 自暴自弃 理由 更 不忘 初心 坚定 走 吾 心信 可行 移山填海 之难 终 成功 日   高三 搬上来 勉励 真的 希望 三年 前 咬着牙 撑下去 股劲来 目标   
 墨水团子-: 2019 年 下半年 好好 努力 ！ 保重 身体   珍惜 时间   好好 生活 开心 快乐 加油 加油 加油   
 Ziho智豪: 感觉 情怀 快 撑不下去 哈哈哈哈 
 虎哆: 生日快乐 两位 老哥 微博 贴纸   
 子薇格格wei: 倒计时 day14 学校 里 撑不下去   宿舍 风扇 坏 一年 报修 好 几次 都 说 修 只能 换   夏天   早上 四五点 热醒   一身 汗   每天晚上 会 断电   小 风扇 电能 充 不了   脆弱 睡眠   四五点 醒 再也 睡不着   白天 上课 好困     贼 烦人   磨 不想 吐槽   
 8211页: 来到 人世间 婴儿 手 脚 无限 快乐 手脚 越长越 大 快乐 一点一点 蒸发   
 鸭鸭鸭血大魔王: 撑不下去   药 吃 心慌 难受 不 陪 聊聊天 再 睡   真的 没人 爱   
 Z恩Z恩P大桢: 点 冰 巧克力 （ 不去 奶油 ） 芋圆 波波 茶 喝 干干净净 月初 不来点 糖分 真的 撑不下去 
 Yuri_Blue: 最惨 听到 人 说 撑不下去 回来 都 好像 去 地方 称为 回来   
 TY走花路: 李泰容 0701 生日快乐   最 喜欢 歌 最 爱 人 
 溜号走神分心恍惚中: 建党 节 快乐   
 可爱小赵一米八: 真好 
 南京市公安局地铁分局: 庆祝 建党 98 周年   生日快乐 ！   L 南京市 公安局 地铁 分局 微博 视频   
 橦執: 難自渡 : 撑不下去 只想 奔赴 朋友 怀抱 里 都 说 都 不用说 喝酒 吃火锅 都 治愈 
 噗嗤一起沉迷紫色呀: 出道 九 周年 快乐 小 公举     爱 一万年 
 一直都要哈哈哈: 柳暗花明 才 我快 撑不下去 ！ ！ ！   
 vLillianAnny: 快乐 金门 2 日游   Vlog   
 华hh我呀yu: 一点点 累 感觉 我快 不 不 委屈 强撑 不 说 没 想象 坚强   
 你看小橘笑得多开心: 朱一龙 工作室   小室 诶 刚 下班 回来 洗漱 躺 先 祝您 七月 快乐 包 问候 咱哥 好 好好 休息 ！   
 幻以诺: 自闭 撑 很 久 最终 某天 深夜 撑不下去 不 难过 不好过 还 白天 挺 好 晚上 要死 白天 不想 活下去 都 一瞬间 做 爱与恨 一瞬间 再 做 一瞬间 脑袋 像是 光速 回忆 发生 事 直觉 判断       展开 全文 c 
 筱零酱: 齐齐 生日快乐 ！ R1SE - 张颜齐 
 Paco_Yao: 那次 冒险 半夜 上山   争拗 中 队友 不想 撑下去 尝尽 自由   感到 没趣   今日 推荐 《 任我行   -   陈奕迅 很长 时间 里 单曲 循环 歌 曲风 很 顺畅 一气呵成 感觉 之外 歌词 真的 很 值得 细细 去 琢磨 歌词 里 主角 从小 固执 倔强 追求 自由 长大 后 慢慢 学乖 变得 不再 勇敢 开       展开 全文 c 
 笔杆獠牙: 0701 夏目 贵志 生日快乐   生日快乐 宝贝 宝贝 大 宝贝 全世界 最 温柔 男孩子 声音 故事 爱上你 永远 做 高中生 做 叔叔 阿姨 小孩子 做犬 之会 夏目 大人 永远 遇见 温柔 人 善良 妖怪     
 念七: 调整 作息   调整 心态 尸姐 : 再 钻牛角尖 辣条娘 :   怕   勇敢 一点 好 一点 M 大王 巡山 : 想要 都 拥有 得不到 都 释怀 苍南 派 : 快乐 工作 快乐 生活 雨 玲玲 zjl : 愿 努力 不负 期望 ali _ thin : 求 减肥 Tiger 公子 : 再 生病 
 FREEDOM平: 太 心声 太 真实   貴方 と の 時間 は   い ま や 夢 の よ う   etnw 两年 半   想到 收录 live 都 收录   疯狂 流泪   怀疑 到底 去 看 一切都是 臆想 梦 数着 能见 日子 撑下去   还 高强度 追 多久   最 喜欢 solo   live   出张 碟 求求   说 都 烦 
 Tronrto: 舍友 陆陆续续 身体 小毛病 一个 喉咙痛 一个 感冒 发烧 第一 时间 去 解决 拖 想想 高三上 学期 明明 感觉 发烧 感冒 无力 持续 几天 硬是 感觉 还 撑 撑 药 不怎么 吃 撑 一个 星期 才 好 鬼 身体 熬过 高三 下学期 喉咙 发炎 连续 几天 越       展开 全文 c 
 历历如惠: 党 生日 祝党 生日快乐   
 别人口中的王村姑: 异地 才 刚刚开始 撑不下去 一个 人 走 一个 人 ！   
 桃子馅汤包: 李泰容 0701 生日快乐 ace 绒 生日快乐 ( tc 热 搜 难以捉摸 )   
 网友急急路过: 行 溪流 岚 : 北国 佳人 李春姬 : 时代 痕迹 Tiger 公子 : 纯良 英俊 笑了笑 : 太 奇妙 36 年 后 比照 莫名 感动 江南 大 野花 : 纯真 笑脸 快乐 童年 特别 几个 小朋友 长大 后举 当年 照片 感动 月刊 勇者 KuMa 君 : 牛 逼 这才 拍照 意义 所在 留下 故事 
 源哥的应援色3: 源哥 应援 色 :  王源 隋玉 欧欧 兔 : 源代码 9 中队   源代码 _ SourceCode : 王源 滚烫 青春   毕业 快乐 ！ 努力 更好 大人 TFBOYS - 王源   源代码 _ SourceCode :  王源 王源 代言 肯德基   些 过程 经历 大人 ； 记忆 欢聚 瞬间 唤起 
 我爱你一隆: 姚琛 努力 努力 创 业绩   ； 跳舞 舔 屏 彩虹 屁     ♀ ； 碟 尖叫 超顺 R1SE - 姚琛 :  R1SE                     入住 新 家 快乐 ～     10 年   20 年   30 年 R1SE Family       Together   Forever           
 奇思妙想呆毛: 家 心灵 港湾 这句 话 字面 理解 一个 人 原生 家庭 独立 欲望 日后 会 独立 孩子 之间 最 融洽 相处 关系 不 涉及 利益 孩子 在外 打拼 再苦 再 累 绝不 父母 积蓄 度日 实在 撑不下去 回家 家人 想想 向往 生活 hp 满格 振作精神 父母 孩子 操心 却       展开 全文 c 
 汉澳sinox2013-李炎: 回复 0 点 _ 童话 : 投降 ？ 评论 锋芒太露 人 打击 赖 ？ 评论 不 ？ 中兴 不服 美国 去 支持 伊朗 罚 十亿美元 乖 只 小狗 敢 保证 华为 不 走 中兴 老路 ？ 再 看 极力 吹捧 华为 会 投降 撑不下去 会 投降 曲线救国 公司 去 撑 伊朗 本身 错 公司 
 洛釉c: 集市 上 鱼 水分 蒸发 差不多 时常 就要 撑不下去 适时 吝啬 地洒点 水 便 再 提着 一口气 蹦 哒 两下 作出 生龙活虎 样子 看 前途 未卜 痛苦 里 周而复始 死 偏 不肯 温柔 豢养   2 西安   
 不可以吃的包包: 上半年     剩下 半年 曾 很多 快 撑不下去   崩溃 掉 时刻 照样 走 经历 过太多 不 阶段   内心 变强 下半年 目标   先 好好 减脂     工作 先 做   至少 先 茶米 油盐   解决 温饱   
 用户6889004658: 撑不下去 会 有时候 撑 不撑 住 心态 放好 对手 特别 希望 死 希望 疯 何必 上当 说 胳膊扭不过大腿 水能载舟 覆州 蝼蚁 苟且偷生 力量 再 悬殊 不战而败 只 剩下 一个 人 不 做 逃兵 清白 受害者 何惧 栽赃 迫害 事       展开 全文 c 
 傻丫头meme: 七年 一晃 时间 竟然 快 爸 想 撑不下去 都 会 照片 想到 小时候 期望 便 更 勇气 多年 都 身边 不 方式 陪伴着 不 做 一个 支持 更好 建议 请 我会 更 努力         展开 全文 c 
 哎呀呀我还在等: 七月 你好   不再 我明 饮鸩止渴 却 甘之如饴 我怕 没 稻草 真的 撑不下去   
 肉包里没肉: 生病   生病   生病   回忆 专用 小 马甲 : 想要 快乐     花泽 美美 : 好好 赚钱 ！ 别想 没   M 大王 巡山 : 想要 都 拥有 得不到 都 释怀 苍南 派 : 快乐 工作 快乐 生活 雨 玲玲 zjl : 愿 努力 不负 期望 ali _ thin : 求 减肥 Tiger 公子 : 再 生病 
 encounter晨曦: zxc668   杨浩 摇头 道 一鼓作气 ？ 攻城 之战 哪有 三天 五天 十天 半月 ？ 连番 大战 之下 兵 铁打 哪有 不累 不乏 再者说 刚刚 招纳 降兵 扩张 大 地盘 大 一块 肥肉 吞下去 总得 稳 稳妥 妥地 化作 腹中 食物 才 好 想要 一口 吃 成个 胖子 还 不 撑   
 糯米团子鸭鸭鸭: 永远 都 摊上 样子 犯贱 爸妈 快 饿死 房里 挺 不   真的 撑不下去 真的 饿死 房间 判刑 不好过   没事 有时候 想要 极端 自残 发泄   想 死 掉   摆脱 一点 痛苦   伤心   会 惩罚   痛苦       展开 全文 c 
 钴鹤: 撑不下去 吃 桃子 喷 一点 香水   
 就是樱蓝呐want做锦鲤: 熊呆 特别 呆 : 好 棒 男孩子 七月 愿 快乐 勇敢   查看 图片 
 Wngchng_: 李泰容 0701 生日快乐   Happy   TY   Day     LWngchng _ 微博 视频   
 宋大大大大大楷: 逃避 才 世界 上 最让人 上瘾 东西 压力 大到 撑不下去 认定 方向 终点 崩溃 语无伦次 所有人 恶语相向 朋友 都 搞 丢 越 想 活得 样 却 发现自己 连狗 都   2 济南 · 山东大学 兴隆山 校区   
 CANNOT-HOLD-BACK: 0701 夏目 贵志 生日快乐   亲爱 夏目 温柔 少年 愿 世间 美好 都 生日快乐 
 TheLoverTop: 熬夜 回忆 专用 小 马甲 : 想要 快乐     花泽 美美 : 好好 赚钱 ！ 别想 没   M 大王 巡山 : 想要 都 拥有 得不到 都 释怀 苍南 派 : 快乐 工作 快乐 生活 雨 玲玲 zjl : 愿 努力 不负 期望 ali _ thin : 求 减肥 Tiger 公子 : 再 生病 
 我超认真哒: 恰 火锅   感觉 撑不下去   吃点 开心   加油   
 Okasiaaan: 啊啊啊 真的 好累 好 无力 真的 快 撑不下去 加油 更好 重聚 疏远 更好 我会 慢慢 走向   
 爱威爱然: 承认 我过 一点 不好 很多 真的 都 熬 不   快要 崩溃 不 压力 改变 都 太 好多 事情 真的 接受 不了   无力 抗拒 只能 哭 完 再 爬起来 老老实实 走 这辈子 从来 没 坚强 大小 坎 都 死 撑过去   
 花花丸子头: 轻松 筹 爱心 接力 ！ - 才 11 岁 爸爸 撑下去 ！   -   轻松 筹   轻松 筹   爱心 人士 你们好 感谢 打开 求助信 袁子翔 11 岁 爸爸 58 岁 爸爸 总和 别人 说 儿子 缘分 浅 ...   O 网页 链接   
 得得木一: 李泰容 0701 生日快乐 
 爆炒方方面: 北国 佳人 李春姬 : 时代 痕迹 Tiger 公子 : 纯良 英俊 笑了笑 : 太 奇妙 36 年 后 比照 莫名 感动 江南 大 野花 : 纯真 笑脸 快乐 童年 特别 几个 小朋友 长大 后举 当年 照片 感动 月刊 勇者 KuMa 君 : 牛 逼 这才 拍照 意义 所在 留下 故事 青 艸 堂 : 這 篇文章 特別 採訪 36 年 後 找到 「 小 
 男红娘: 男 红娘 人生 风景 多姿多彩 做人 一颗 平常心 辛辛苦苦 来到 世界 上 快乐 纯粹 自然 产物 世事 繁杂 心 依然 情怀 依然 ； 颠簸 流离 脚步 依然 追求 依然 ； 岁月 沧桑 世界 依然 生命 依然   
 大哥晨dd: 路上 都 很 快乐 开心 不   2 台湾   
 NO_Champion: 快 撑不下去 再 逼 一把   
 潘小胖要天天开心: 过不下去     车该 开   喜欢 摄影 学   工作 撑   ...... 着急 慢慢来   着急   慢慢来 着急   慢慢来 想要 都 会   
 笨太郎回来了: 评论 里 说 很 怀念 18 年 快乐 杠精会 顾及 很多 没 放 开 看 首映 很 紧张 样子 好 心疼 
 扶姚琛王: 姚琛 Cookies   yc   姚琛 仓鼠 侠   姚琛 未来 期 ！ 天寒地冻 、 路远 马亡 陪你到 达 广阔 海洋 ！ 6.8 姚琛 再 道 一句 出 道 快乐 R1SE - 姚琛 
 喵性女孩P: 睡 : 消防员 撕心裂肺 哭声 还 记得 努力 猫 阶级 : 记得 女孩 跳楼 前 消防员 说 谢谢 真的 撑不下去 苦苦 挣扎 那段 黑暗 时光 里 不到 一句 抓 
 窑皖熙: 都 一颗 开心 快乐 心情     
 sunXkun: 好 快 都 下半年 半年 好像 等待 中 度过 包括 刚刚 癫疯 之夜 苦 快 一个月 都 崽 崽 很多 事 工作 很 忙 猫 生病 离世 大大小小 烦心 事情 都 快 撑不下去 好像 还行 份 割舍 依赖感 反而 更 勇气 面对 事情       展开 全文 c 
 活在淡水里的咸鱼: 绝美 嗓音 绵羊 0318 : 学不 这歌 撑 太绝 感叹 梨 阿琳 : 不醉 死 声音 里   ♀ 
 易烊烊的冰淇淋: 梨涡 圆周率 : 不 优酷 刷 街舞 这烂 节目 视频 不 给予 热度 看千玺 只 看 cut 到时候 贵 节目 还 高 热度 做 贵 节目 您们 所宠 几位 队长 粉丝 节目 撑 多久 ？ 
 达石华: 《 儒 释道 文化 浙大 博士 跳江 自杀 孩子 撑不下去 15 张 照片   ! O 浙大 博士 跳江 自杀 孩子 撑不下去 15 张 照片   !   
 Y__晴晴: 好 朋友 生日 快乐 日爱   
 繁华6143121420:  晚安 语录 人 独自 前行 任何人 都 帮不上忙 再苦 再 难 撑下去 有时候 真的 想象 还要 强大 微博 贴纸   
 Gio_莫太: 生日快乐 
 查無此人sor: 金秀贤 正式 退伍 九句 话 撑不下去   
 低洼癌肿訾: 哥本哈根 食谱 DAY2   早起 减重 3.6 斤 原本 早上 只 喝一杯 咖啡 早餐 感觉 没 变化 两餐 都 吃 很 撑 暂时 饿到 不 接下来 会 很 痛苦 慕恋 18 号 成都 签售会 瘦瘦 美美 地去 见 咬牙 坚持下去 ～   
 C曹庆Q: 减肥 打卡 第一天 好 饿 啃 几个 水果 + 两个 火腿 期待 明天 到来 吃 东西 预感 一个月   估计     撑不下去 ！ ！ ！ ！   
 Erika-TS: 浅光 ShallowBlue : 希真姐 评论 特儿 生日快乐     查看 图片 
 宋大大大大大楷: 逃避 才 世界 上 最让人 上瘾 东西 压力 大到 撑不下去 认定 方向 终点 崩溃 语无伦次 所有人 恶语相向 朋友 都 搞 丢 越 想 活得 样 却 发现自己 连狗 都   2 济南 · 山东大学 兴隆山 校区   
 EGG刘昕妍: 时间 真 快 下半年 
 吴泡泡是好蛋蛋: 好累     董加伟     一件 事情 都 撑不下去   
 婧儿Jing5288: 周末 假期 早上 夜里 记不清 多久 日子 只 想 十点 回家 陪陪 妞妞 奢望 希望 阳光 不骂 脏话 都 撑不下去 日子 ～   
 马文婧-: 人 对待 情感 底线 祝人 幸福 太难 祝你快乐   2 西宁   
 我不是叁叁啊: 祝 生日快乐 快乐 哈哈哈   
 Yikefeizifen·: 再 不 拉屎 我撑 躺 不   
 猫在撒娇: 都 撑不下去 早点 死 掉 拜托 拜托   
 俆_dan: 集市 上 鱼   水分 蒸发 差不多   时常 就要 撑不下去   前途 未卜 痛苦 里 周而复始   死   偏 不肯 温柔 豢养   
 ChanChiLam: 12 月份 刚 喜欢 上声入 人心 1 月份 正式 入坑 回想 发现 真 怀念 还 没 乱七八糟 人和事 氛围 很 开心 很 快乐 开开心心 地去 评论 听 唱歌 看 表演 看 评论 区 开玩笑 乌烟瘴气 都 涌 进来 很 平常 开 玩笑 人 说 不 尊重 还要 教育 随时       展开 全文 c 
 Lynnmybell: 心理 情绪 愈加 敏感 感受 快乐 痛苦 能力 比例 增长 总体 来讲 很 多谢 年纪 大 回事 感受 事情 角度 维度 都 广阔   
 用户6851256873: 约 吃 甜品 看 电影 始终 进一步 动作 连好 几次 碰到 手 都 牵 天下 小雨 撑 伞 散步 想 笨蛋 不 主动 ？ 路过 小桥 时 折起 伞 扔 河水 里 愣住 笑 说 一个 人 淋雨 恍然大悟 咻 一声 伞 扔下去   
 不要乱来: 才 第一天 感觉 撑不下去   
 墨染朵朵: 简单 、 温暖 、 看似 唾手可得 小 快乐 原本   晨光熹微 繁星 闪烁 寒潮 、 风雷 、 霹雳 雾霭 、 流岚 、 虹霓 每一分 每一秒 都 错过 可惜   
 LXX-kk: 林宥 嘉 0701 生日快乐     感谢 陪伴 很多年 林爸 第一个 生日 希望 都 健康 快乐 我会 应援 ！ 
 冯小萌1101: 承认 我过 一点 不好 很多 真的 都 熬 不   快要 崩溃 不 压力 改变 都 太 好多 事情 真的 接受 不了   无力 抗拒 只能 哭 完 再 爬起来 老老实实 走 这辈子 从来 没 坚强 大小 坎 都 死 撑过去   
 俊櫋: 今日 快乐   说 下午 学不 看 一集 电视剧   舍友 说 图书馆 平板 干 事情 超   前 几天 很 远 一个 男生 平板 玩 蜘蛛 纸牌   一个 舍友 说 手机 里 下过 扫雷   袁 爷爷 吃 太饱   吃饱 撑 干 事 哈哈哈 哈哈哈 哈哈哈 哈哈哈 哈哈哈 哈哈哈 哈哈哈 哈哈哈   
 多多是doodle: 周六 野 Day93 下半年 第一天   大姨妈   10min 改善 斜方 肌 10min 臀腿 5min 瘦 手臂 30 反式 撑体   几天 再 恢复正常 回想 上半年   105 - 88 - 92   不再 专注 我要 减肥 一件 事   不再 过度 节食   世界 上 完美 身材   试着 学会 接纳 不 完美   努力 追求 更 健康 生活 方式   坚持下去       展开 全文 c 
 1999Part2: 北二环 路上 吼 很 大声 要死 ！ 终于 要死 ！ 撑不下去 ！   巴不得 全世界 都 分享 喜讯   没 病   会 明白 到底 多么 人 开心 一件 事情   没人 分享 喜讯 终归是 失落   寂寞   
 汉堡很饿哎: 新宠 coco   早上 饿得 感觉 吃 完 一桌 喝 杯 豆浆 吃 四个 小笼包 吃不下 想着 浪费 碗面   愣 撑下去 半碗   难   
 honeypollywoo: 奔 三 感觉 真累 可一 休息 原罪 感 九点 去 睡觉 满心 羞愧 可真 撑不下去   
 24小时专业救妈队: 哥哥 生日快乐   爱 
 欧尼是个小仙女啊: 一名 中共党员 骄傲 自豪 ！ 祝 我党 98 岁 生日快乐 ！ ！ 
 Hell3rGoh螺: 森日 快乐 大 帅哥 
 哇咔咔哩kaka: 每次 都 送 送 走 远 一步 爱 牵挂 便 多一分 亲爱 生日快乐 ！ 故事 都   
 打不倒的羊羊-: 很多 真的 快 撑不下去 咬咬牙 挺 下半年 努力 Hello 七月   
 是一只菜呀: 抱 刚 买 奶盖 茶 摔   胳膊 撑 怕 奶盖 撒   直挺挺 跪   膝盖 上 好大个 疤 
 ·樱花草莓星冰乐·: .... 孟 女士 真的 看剧 阻力 我快 撑不下去   
 用户6170208265: 中国 失踪人口 档案库 官网 : 回复 平安 随州 : 儿子 快 回家吧 妈妈 撑不下去 ！ 爸前 几天 出车祸 紧急 救治 刚刚 脱离 危险期 哀怨 查看 图片   平安 随州 : 随警 提示   请 扩散 ！   
 _dhdjxidbdjsnbsajkwvdjsw: 7 月 ！ fight   ! fight   ! 会 不 撑下去 ！ 大大的 努力 小小的 梦 ！   
 99年的老油条: 迟到 生日快乐   ！ ！ 大洋 文 警院 男女排   
 红烧牛肉干脆面: 再 渣 男 流泪 回忆 专用 小 马甲 : 想要 快乐     花泽 美美 : 好好 赚钱 ！ 别想 没   M 大王 巡山 : 想要 都 拥有 得不到 都 释怀 苍南 派 : 快乐 工作 快乐 生活 雨 玲玲 zjl : 愿 努力 不负 期望 ali _ thin : 求 减肥 Tiger 公子 : 再 生病 
 一只花豹meow: 做人 狗狗 学习 快乐 很 简单 开心 表达 不 开心 汪汪 愤怒 发火 先低 吼 警告 喜欢 人 表现 蹭 蹭 蹭 吃饱 肚子 运动 运动 ...... 
 Xiao年轮: 撑不下去 很 幸福 谢谢   
 micky_yoyo: 字念晟   坚果 ai 窝窝   咸蛋 嘚 瑟 妞   素素 粥 粥   这样的话 在家 擦 防晒霜 撑伞 活不下去 感觉 
 cby的小圈子: 电视剧 水 男孩   「 真的 撑不下去 」 啜泣 脸 埋进 双手 拍 肩膀 鼓励 「 撑下去 ！ 难道 忘 时 我俩 许下 誓言 ？ 300 一个 人 自助餐 ！ 」   
 世界末日女朋友ii: 撑不下去   道别 罪   
 是吴Cheery啊: 续命 牛奶 下半年 好 一点 真的 快 撑不下去   
 顶级难泡玫瑰茶: 日常 纠结 买手机   手机 撑不下去 不想 修   立马 换 不了   XS   MAX   XR 8P 之间 纠结 喜欢 8p 拍照 效果   据说 打游戏 很 流畅 众多 测评 里 表现   总 感觉 买 新 不 买 旧   怕 Xs   max 信号 不好   变砖   毕竟 价格 不 便宜   大 重 喜欢 白色 xr   信号 不 咋办         展开 全文 c 
 王靳一北: " 分享 浙大 博士 跳江 自杀 孩子 撑不下去 19 张 照片 凌桐爬凌: 翟潇闻 爸爸 父亲节 快乐 R1SE - 翟潇闻 
 换个昵称不想被别人找到: 世界末日 撑不下去   
 JIFFA: 鸡崽崽 快乐 长大 日 天日 地钦 仔仔     陈八虎     热心 网友 小鹅     _ OXXW 
 bobbyxiyolo: 下半年 希望 学业 为重 高中 三年 都 好好 努力 高一 高二 放松 不 希望 到时候 高三 撑不下去 反正 好好学习 天天向上 头脑清醒 端正   O2019 下半年 目标 都 为此 做过 计划 ？   
 用户6138612143: 望穿 秋色 凝波 事情 发生 2018 年 十月份 浙大 博士 失踪 只 留下 一份 遗书 四天 后 钱塘江 打捞   浙大 博士 跳江 自杀 孩子 撑不下去 几张 图 ！   O 网页 链接   
 爱笑又爱哭的小雯子: 人生 总有 一段 孤独 走 时光 理解 撑下去 好   
 S九尾妖狐: 摊上 婆子 倒 八辈子 霉 ！ 不 想带 孩子 离开 感觉 撑 很 累 ！   
 随意吐槽的小透明: 百度 一个 百度 前 阵子 内容 全都 清空 还 发消息 催 去 签到 不 去 签到 还 扣 分 还 恐吓 再 不让 做 主 奇 怪 不让 里 内容 做 主 干嘛 做 一个 白板 主 ？ 吃饱 撑 ？   
 三两合欢: 高中 用过 一个 软件 湖畔 模式 很 舒服 app 说 下架 下架 零星 导出来 数据 忘 用米 田 真的 换 手机 必备 app app 苹果 手机 定期 上线 刷 更新 看遍 开发人员 介绍 担心 运行 会 将来 撑不下去 还 发过 信息 感谢 辛苦 加油 
 Cibudayiyiyi: 七月 才 暑假 第一天 撑不下去 感觉 人 精疲力尽 心力交瘁 有时候 真的 真的 不想 累   
 易烊烊的冰淇淋: 梨涡 圆周率 : 不 优酷 刷 街舞 这烂 节目 视频 不 给予 热度 看千玺 只 看 cut 到时候 贵 节目 还 高 热度 做 贵 节目 您们 所宠 几位 队长 粉丝 节目 撑 多久 ？ 
 沙玛釰钬: 集市 上 鱼 水分 蒸发 差不多 时常 就要 撑不下去 适时 吝啬 地洒点 水 便 再 提着 一口气 蹦 哒 两下 作出 生龙活虎 样子 看   前途 未卜 痛苦 里 周而复始   死 偏 不肯 温柔 豢养 分享 单曲 K 心酸 （ 网易 云 音乐 ）   
 季盼啊啊啊啊啊: 咳嗽 第四天 真的 不行 撑不下去   
 可爱且迷人呐: 愿 世界 上 都 平平安安   愿 翟潇闻 开心 快乐   爱笑 男孩 喜欢 R1SE - 翟潇闻 R1SE - 翟潇闻 : 注意安全   
 MeMHeH: 加油 VIHO 身体 段时间 超忙 事情 都 会 一件 一件 解决 哈哈哈 哈哈哈 每次 撑不下去 这句 话 安慰 昊昊 超级 魅力 dancer ！ ！ ！ dancer   dancer   dancer 
 安安的火树琪花: 宝贝   听 说 很 辛苦 那种 看不见 、   身体 上 、 精神 上 、 人际关系 上 、 学习 上 、 感情 上 、 面对 未来 那种 无力感 感觉 很累 好像 撑不下去 亦 拼命 自我 救赎 挣扎 不想 很 煽情 去 安慰 安慰 会 软弱 肆无忌惮   不 受 控制 一个 人 都       展开 全文 c 
 Okasiaaan: 啊啊啊 真的 好累 好 无力 真的 快 撑不下去 加油 更好 重聚 疏远 更好 我会 慢慢 走向   
 Sherlockkkk: 我球球 西兰花 赶紧 出 BDCDDVD 行不行 只靠 前三刷 记忆 我快 撑不下去 
 橘子苞米花蔚: 撑不下去 
 蒜泥麻油火锅: 加油 辜负 M 大王 巡山 : 想要 都 拥有 得不到 都 释怀 苍南 派 : 快乐 工作 快乐 生活 雨 玲玲 zjl : 愿 努力 不负 期望 ali _ thin : 求 减肥 Tiger 公子 : 再 生病 
 记住我叫你二哥: 写给 [ 转发 ] 九句 话 撑不下去   
 老头儿是亲的: 反正   追 一对 西皮 入戏 西皮   想得到 快乐   不到 G 点 .... 喜欢   干涉   当初 zh 各圈 爬墙   确实 空前绝后 盛况   圈子 早 没   何必 执念   
 悠然_40418: 轻松 筹 爱心 接力 ！ - 行善 一种 轮回 请 救救 女儿 ！   -   轻松 筹   轻松 筹   犹豫 很 久 最终 发起 这次 求助 撑 很 久 实在 撑不下去 求助 人张 自兵 患者 小女儿 张菁 来自 湖北省 襄 ...   O 网页 链接   
 Amblin_Yao: 迟到 生日快乐 
 nayeon的兔牙: 营销 号 不 带 拉 丽萨 活不下去 天天 吃饱 撑 比来比去 无聊 死 赢 营销 号 会 颁 大赏 真鸡儿 无聊   
 Cynthia0701: 半夜 惊醒 真的 撑 感恩 发生 七月 快乐   
 我的心里住了一只小怪兽:  林宥 嘉 看着 天上 一朵 云飘着   而风 听 风里 一首歌   过生日 火车 上 看着 外面 风景 想到 首歌 祝 生日快乐 林宥 嘉 YogaLin   生日快乐 家鸽 ！ 生日快乐 小 酸奶 ！   
 mrrsw2715389: 两天 看 弟弟 ins 上发 书 难看 哪一方面 来说 都 不算 好 撑 看 两天 看不下去 很 想 弟弟 本人 抓 质问 说 说 ！ 好看 ？ 说不出来 骂 死 ！ 严谨 追星 态度 弟弟 ins 只发 图 没说 书 猜测 不 好看 没 好意思 说   
 雷哥哥和梦宝宝的日食记: 本来 一点 不 饿 看 蒋 阿姨 晒 午餐 饿 爆 还 买螺 狮粉 简直 大厨 距离 一包 方便面 佐料 差距 天气 天意 ## Hello 七月 ## 可爱 一夏   一个 火腿肠 吃 撑   
 用户7078711191: 一个月 都 撑不下去   太难   太 难过   
 雷哥哥和梦宝宝的日食记: 本来 一点 不 饿 看 蒋 阿姨 晒 午餐 饿 爆 还 买螺 狮粉 简直 大厨 距离 一包 方便面 佐料 差距 天气 天意 ## Hello 七月 ## 可爱 一夏   一个 火腿肠 吃 撑   
 芒果冰Jenny: 简妮 跳 操 打卡   近 半个 月 记录 教练 陆陆续续 休假 cross 停掉 都 bodypump 撑 偶尔 cxworx 填 一点 坑 yellow   circle 戴 心率 带 不 app 上 记录 接下去 三周 训练 课程 更 堪忧   
 咕噜咕噜冒泡泡咿呀咿呀哟: 好 做 一个 成熟 大人 却 发现自己 站 大人 世界 权利 选择 成长 快 不 快乐 不 懂事 好   
 Fay我是费依: 陈情 令 孟情 令 第三集 不 打算 看 玩意 薛洋 鬼 夷陵 老祖 修鬼道 操纵 死人 开山鼻祖 干嘛 薛洋 加戏 ？ ？ ？ ？ 蓝氏 双 璧 都 丑 ？ ？ ？ ？ 蓝曦臣 个素 人样 蓝忘机 两眼 无 神 一副 没 睡醒 样子 配音 撑 看 仙家 云梦       展开 全文 c 
 阳光小甜萱: 撑不下去 很 难过 很 担忧 周二 周三   
 喜欢我你不会吃亏的: 真的 好苦 我快 撑不下去 爸爸妈妈 都 去 医院 陪 外公 没 空管 前 几天 打电话 说 老年痴呆 症状 回去 不 扁桃体 发炎 还 低烧 好 难受 胃里 不 舒服 中午 喝 几口 粥 吐 大三 还要 分 方向 想选 网络 家里 不让 人 做主 份 小学       展开 全文 c 
 renfen05: 梁博 元宵节 快乐 希望 放烟火 ！ 一年 新 新 期盼 ！   
 悄悄地跟你说天慢慢亮了: 我快 崩溃 真的 撑不下去   
 六源的元: 真好 一只 丧鹅 : 看起来 好 快乐 蛋黄 太厚 : 好 治愈 啊啊啊 啊啊啊 太 喜欢 
 口水淫娃: 杨幂 ## 杨幂 绿苑 十 一周年 时光 变 寻寻 幂 幂 爱 不离 不弃 守护 十一年 一个 数字 却是 一路 风风雨雨 走过 一步 欢笑 泪水 激动 艰辛 经历 太 很 幸运 都 蜜蜂 狐狸 撑起 天 相约 一年 绿苑 陪 杨 幂 走   
 我在宇宙间逃亡: 简单 真诚 小孩   温柔 明媚 少年 七月 快乐 大 男孩     愿望 疼爱   
 椰律宝丽珠: 快乐 真的 很难 一个 阈值 真的 好好 对待 此时此刻 快乐   
 简单学习网允儿老师: 真的 一点一点 都 不想 学习 不 学习 不 会 时代 淘汰 别人 讨论 会 说 只会 干什么 都 世间 机会 会 选择 只能 撑下去 知识 难 看 几遍 能看懂 看 看不去 逃避 能看懂 ？ 都 努力       展开 全文 c 
 别人口中的王村姑: 异地 才 刚刚开始 撑不下去 一个 人 走 一个 人 ！   
 桃子馅汤包: 李泰容 0701 生日快乐 ace 绒 生日快乐 ( tc 热 搜 难以捉摸 )   
 IVY桢: 1 、 学会 温和 对人对事 随意 发脾气 都 不 欠 2 、   学会 宽容 人 都 难处 都 不 3 、 学会 放弃 拽 越紧 痛苦   4 、 学会 低调 取舍 间 必有 得失 不用 太 计较 5 、 学会 简单 踏实 务实 不 庸人自扰 越 简单 越 快乐 6 、 学会 忘记 [ 泪流满面 ] 咔 咔西西 善忘 一件       展开 全文 c 
 用户6767380645: 才 没用 垃圾   「 真的 撑不下去 」 啜泣 脸 埋进 双手 拍 肩膀 鼓励 「 撑下去 ！ 难道 忘 时 我俩 许下 誓言 ？ 300 一个 人 自助餐 ！ 」   
 -萱的王-: 想念 p3 好 皮肤   很少 长痘 满脸 闭口 痘痘 图书馆 说 再见   朝九晚 十坐 一个 星期   屁股 都 快 坐平   考试 都 撑不下去   假期 快乐   
 小鑫的河马: 优路 14 年 　 最 珍贵 ## 优路 14 年   最 珍贵   生日快乐 ～ [ 加油 ] 
 一人旅Q: 喜欢 一个 人 喜欢 不 快乐 何必 ？   
 奔二少女冲鸭: 一到 关键时刻 痛经 月 不用 吃 布洛芬 不 疼 去 博物馆 死去活来 都 没 逛 撑不下去 躺 半天 好多 布洛芬 随身带 orz 夏天 短裤 舒服 收回 当初 说 怕 晒黑 随手 一拍 最 凉快   
 杳鸢柒: 许在 生日 月 愿望   希望 快乐 一点 感动 一点 惊喜 一点 拥有 一点 至少 都 好 拜托 二十岁 神   
 Malemaker_0813: 李泰容 0701 生日快乐   ReinaMadre : 带 李泰容 0701 生日快乐   转发 这条 微博   明天 抽 一个 妹妹 请 吃 ladym 蛋糕   祝 偶们 bb 本命年 心想事成 身体健康 
 明少Harry: 电影 里 说 之间 无缘 分 全靠 死撑 明白 这话 直抵 泪点 却 说白了 爱 一个 人 真的 一个 人 事儿 拿出 过日子 态度 还 想 大不了 哭 一场 硬着头皮 爱 世间 缘分 不 缘分 都 撑 — — 七 堇 年   分享 单曲   K 花儿   ( 电影 《 那时花开 片尾曲 )   (       展开 全文 c 
 安利菌: 拍可孚 都 囤 一个 小时 抢 几万 件 库存 ！   2 片装 只 剩下 8 千件 ！   刷新 掉 好几件 速度 估计 撑 不了 多久 还 想 囤 快   安仔 翻 下 评论 大部分 蛋仔 都 好用 肤质 感 般的   蛋仔们       展开 全文 c 
 董略略略: 哈哈哈 哈哈哈 赢 造型 赢 : 哈哈哈 太 可爱 莫染 改名 _ : 接下来 一周 更久 看 姐姐 微博 收获 快乐 
 小猪猪猪猪猪猪猪猪猪猪啊: 撑不下去 加油 未来 会 一个 能带 光亮   
 喜欢金希澈先生的vv: 里 兜   少女 大总统   朴正洙 生日快乐 ！ 
 我一定会早睡: 努力 挣钱 小羊 爱 吃 酱 肘子 : 想要 爱 朋友 都 好好 ！ 回忆 专用 小 马甲 : 想要 快乐     花泽 美美 : 好好 赚钱 ！ 别想 没   M 大王 巡山 : 想要 都 拥有 得不到 都 释怀 苍南 派 : 快乐 工作 快乐 生活 ali _ thin : 求 减肥 Tiger 公子 : 再 生病 
 浦凑幽踊扇慷钟庸mu: 宣酒 6 上市 热销 一周年 生日快乐 ！ 越来越 好 赶紧 上证 上市 ！ 加油 树猫 玫瑰 年 记忆 絶 対 度 
 技术部新员工: 不好意思 撑不下去   
 就是张小玲: 重庆 高估 肚量 一碗 小面 三碗 冰粉 一顿 火锅 吃 撑 还 计划 吃 一路 吃 不 洪 崖洞 新建 很多 商场 两年 前 记忆 中 街景 不   唯一 一个 来过 第二次 城市 十五天 行程 满满的 旅行 结束 回家 睡觉 去     
 ZL小皮孩儿咯咯咯: 拼 尽全力 努力 效果 都 不及 别人 万分之一 太 愚蠢 ？ 撑下去 好 难受 我怕 再也 阳光 想 做 不到   
 MeMHeH: 加油 VIHO 身体 段时间 超忙 事情 都 会 一件 一件 解决 哈哈哈 哈哈哈 每次 撑不下去 这句 话 安慰 昊昊 超级 魅力 dancer ！ ！ ！ dancer   dancer   dancer 
 不知道叫什么好5454321: 逛街 买买 买买 美美 美 吃 吃 吃 撑 撑 撑 从不 主动 逛街 陪 逛 但照 趋势 踏   陪都 不想 陪 VIPonly   
 梦里有彩虹小马: 队长 SuperJunior : 祝福 队长 生日快乐 ！ ！ 利特 0701 生日快乐   朴正洙 0701 生日快乐    SuperJunior  利特  朴正洙   
 用户6540427359: 厦门日报     厦门 本地 新闻     厦门 网     厦门 小 鱼网     农民工 不易 打工 只为 一点点 微薄 收入 老板 耍赖 工资 不愿 发放 十几个 人 做 厨房 集体 起诉 集体 申请 强行 执行 去年 一点 消息 都 整日 整日 法院 跑 没用 累 钱 确实 撑不下去 生活 压力 太 大 恳求       展开 全文 c 
 我是林某某-: 祝 生日快乐 ！ ！ 希望 睁眼 全是 红包 开心 一整天 想想 都 美滋滋 我要 赶紧 睡 睡着 愿望 先祝         建党 节 快乐 ！ ！   2 成都   
 LOU噻: 刚刚 落地 祝曦 狗 生日快乐 ! ( ^ O ^ ) y 诚意 十足 新 一岁 养 更 wa   ？   2 重庆 · 重庆江北国际机场   
 橘子酱鱼籽: 绒绒 生日 粗卡 ！ ！ ！ ！ 李泰容 _ TaeYongBar : 李泰容 0701 生日快乐   感谢 楷灿 生日 祝福 ！ 感谢 楷灿 平日 中 泰容 扶持 最 珍贵 泰容 生日快乐   未来 都 会 闪闪发光 ！ 
 Kimi妈_: 康复 ！ 健健康康 开开心心 ！ 回忆 专用 小 马甲 : 想要 快乐     花泽 美美 : 好好 赚钱 ！ 别想 没   M 大王 巡山 : 想要 都 拥有 得不到 都 释怀 苍南 派 : 快乐 工作 快乐 生活 雨 玲玲 zjl : 愿 努力 不负 期望 ali _ thin : 求 减肥 Tiger 公子 : 再 生病 
 叶幸运和叶小宝的故事: 换个 乐器 多事 接下来 多集 想想 片头 片尾曲 场景 撑下去 说 不 看 时 真香 他俩   锁住 毕竟 演员 拍 很 辛苦 
 陆婷的小鱼: 一年 真的 超 煎熬 超 痛苦 饭上 lu 总 真的 真的 真的 早就 撑不下去 早就 击垮 真的 真的 真的 真的 真的 真的 真的 真的 好 爱 真的 真的 真的 真的 真的 真的 真的 好 想要 见到 很烦 很烦 真的 很烦 在线 流泪   
 约翰尼德普颖: 感觉 撑不下去   
 火叔本尊: 暖 ln : 开心 梨寒 : 六月 真的 快乐 伤痛 并行 小北 迎来 李必 街舞 乱 剪里 秃头 十二 争气 里 笑 开花 希望 七月 请 对崽崽好 晚安 
 一个很丧丧丧的女子: 7   希望 想要 如期而至   希望 快乐 希望 身边 人 都 健康   金元 宝贝 希望 万事 胜意   
 天津吃肀喝玩乐一条龙丨: 宣酒 6 上市 热销 一周年   一周年 快乐 ！   永远 美好 事情 即将 发生 ！ 水 烟雨 空 懂 旋律 小鹿 爱 驯鹿 
 九九呐__: 客户端 名字 回忆 专用 小 马甲 : 想要 快乐     花泽 美美 : 好好 赚钱 ！ 别想 没   M 大王 巡山 : 想要 都 拥有 得不到 都 释怀 苍南 派 : 快乐 工作 快乐 生活 雨 玲玲 zjl : 愿 努力 不负 期望 ali _ thin : 求 减肥 Tiger 公子 : 再 生病 
 打个摩的见花花: 人 不 中途 弃剧   shn     再厚 滤镜 再 撑下去   
 金秀贤是我的小男朋友: 现场 小伙伴 尬 聊 清醒 撑下去 不 犯困 小伙伴 蚊子 好多 挺住 小伙伴 ..... 两年 不 追星 夜排 真的 很 刺激 很 金秀贤 ........ 聊 不  金秀贤 金秀贤 7 月 退伍   
 大白羊老徐: 想起 一个 笑话 前 几天 妈 去 楼下 买 东西 后 爸 楼上 喊 大 太阳 不带 伞 一把 透明 雨伞 哈哈大笑 问 老爸 意识 尴尬 说 撑 能遮点 我妈 带 爸 关心 真的 太阳 下撑 透明 伞 走   
 二木木易: 撑不下去 心情 烦躁 迷茫 就读 一遍   1 清醒 时 做事 糊涂 时 读书 大怒 时 睡觉 独处 时 思考 2 再 难 再 好 淡泊 再 差 再 节省 3 路 不必 别人 标准 框定 人生 4 才华 撑 不起 野心 时       展开 全文 c 
 ababy院长大人: 江南 大 野花 : 笑 死     产粮 大户 刘码 露 : 这才 只播 区区 两天 下周一 二三 加播 两集 好 累 好 快乐 翛 翛 : 害 ！ 我刚 去 突击检查 下 截止 23 点 30 分 投稿 日期 6 月 30 日 陈情 令 视频 854 陈总实 红 
 车厘子大嘴: 哈哈哈 哈哈哈 
 原味高MVP: 大学 刚 毕业 生存 酒店 前台 干着 三个 月 晚上 没 睡觉 上班 白天 睡觉 晚上 上班 感觉 快 撑不下去 专业 相关 工作 却 找 不到 非专业 相关 找不着 很 迷茫 不 再 还 撑 多久   2 长沙   ·   南 门口   
 山川云中: Tiger 公子 : 纯良 英俊 笑了笑 : 太 奇妙 36 年 后 比照 莫名 感动 刘 大鸨 : 悬疑 志 : 江南 大 野花 : 纯真 笑脸 快乐 童年 特别 几个 小朋友 长大 后举 当年 照片 感动 月刊 勇者 KuMa 君 : 牛 逼 这才 拍照 意义 所在 留下 故事 青 艸 堂 : 這 篇文章 特別 採訪 36 年 後 找到 「 小 
 也没有很慌: 有感而发 《 shang 瘾 看 好尬   演员 尬 剧情 尬 台词 尬   会 好   看 两集 撑不下去 ... wyb 好绝 男 （ 暴风 流泪 ）   
 源哥的应援色3: 源哥 应援 色 :  王源 隋玉 欧欧 兔 : 源代码 9 中队   源代码 _ SourceCode : 王源 滚烫 青春   毕业 快乐 ！ 努力 更好 大人 TFBOYS - 王源   源代码 _ SourceCode :  王源 王源 代言 肯德基   些 过程 经历 大人 ； 记忆 欢聚 瞬间 唤起 
 C曹庆Q: 减肥 打卡 第一天 好 饿 啃 几个 水果 + 两个 火腿 期待 明天 到来 吃 东西 预感 一个月   估计     撑不下去 ！ ！ ！ ！   
 目WDD--wanlear--72的: 姚琛 未来 加油 姚琛 入住 新 家 快乐 R1SE - 姚琛   R1SE - 姚琛   姚琛 Cookies   姚琛 仓鼠 侠   R1SE - 姚琛 :  R1SE                     入住 新 家 快乐 ～     10 年   20 年   30 年 R1SE Family       Together   Forever           
 Aimeego: 身体 耐心 都 快 临界点 撑不下去   
 FREEDOM平: 太 心声 太 真实   貴方 と の 時間 は   い ま や 夢 の よ う   etnw 两年 半   想到 收录 live 都 收录   疯狂 流泪   怀疑 到底 去 看 一切都是 臆想 梦 数着 能见 日子 撑下去   还 高强度 追 多久   最 喜欢 solo   live   出张 碟 求求   说 都 烦 
 丝莫尔青: 温情 吹笛 驭 尸 玩意 ？ ？ ？ ？ 加戏 就算 ！ 加江 澄 孟情 感情 戏 算了 ！ ！ ！ ！ ！ 魔 道 祖师 懂不懂 夷陵 老祖 第一 人好 ！ ！ ！ ！ 《 陈情 令 就算 肖战 盛世 美颜 jio 快 撑不下去 ！ ！ 孟子 义 这位 小姐姐 真的 赢 毁 魔 道 祖师   
 木木是只小馋猫: 老子 连约 好 小姐姐 都 没 去 医院 陪 三天 治疗 猫 瘟 敢 撑不下去 老子 绝逼炖 野猫 野狗 ！   
 鸭鸭鸭血大魔王: 撑不下去   药 吃 心慌 难受 不 陪 聊聊天 再 睡   真的 没人 爱   
 yangqqingssss: 不 撑下去 没   
 Robin还不够有趣: 写给 九句 话 — — 撑不下去 心情 烦躁 迷茫 就读 一遍   
 是一只Yumi羊仔啊: 快洛 追星 女孩 每日 孜孜不倦 刷 哥哥 相关 微博 简直 在线 快乐 肥宅 （ 此时此刻 黄 朋友 躲 角落 说话   
 Rail_Y: 提前 祝 平安夜 快乐     
 能把快乐接我一天吗: 像是 集市 上 鱼   水分 蒸发 差不多   时常 快要 撑不下去   适时 吝啬 地洒点 水   便 再 提着 一口气 蹦 哒 两下   作出 生龙活虎 样子 看   前途 未卜 痛苦 周而复始   死   偏 不肯 温柔 豢养   
 我堕入情网你却在大排档: 每次 撑 不   撑   会   好像 没什么 不 Dream   It   Possible - Delacey   
 lovepdsjw_2000: 总有 撑不下去 不想 回头   
 卡哈特朋克女孩-: 生日快乐 永远 温柔 
 陈雅婷_Jo全球粉丝后援会:  陈雅婷   7 月 你好 & 杀青 快乐 陈雅婷 _ Jo   
 一切都要顺利的: 2018 - 04 - 16   17 : 45 : 16     城市 真实 处处 都 人 想 逃离 校园 广播 在播 新闻 螃蟹 剥 壳 快要 撑不下去 站 楼梯 上 人 推下来 走 路上 别人 背后 捅 一刀 掉 进深 水里 濒死 感 窒息 感 无时无刻 不 侵袭 快要 抵抗 不住 安慰 不公 挫折 都 考验 都       展开 全文 c 
 _Pundarika: 说 给予 恩惠 偿还 会 很 麻烦 很 怕麻烦 大多 事情 好 实在 撑不下去 会 找 帮忙 （ 也许 静静 等待 自我 毁灭 ） 讨厌   
 Alienation_TaDa·: 睡 ! 头 真的 秃 明天 快乐 要来 辽 2333GN !   
 8号行星环游记: 希望 盆友们 考研 考公 实习 找 工作 都 满意 小羊 爱 吃 酱 肘子 : 想要 爱 朋友 都 好好 ！ 回忆 专用 小 马甲 : 想要 快乐     花泽 美美 : 好好 赚钱 ！ 别想 没   M 大王 巡山 : 想要 都 拥有 得不到 都 释怀 苍南 派 : 快乐 工作 快乐 生活 Tiger 公子 : 再 生病 
 安安的火树琪花: 宝贝   听 说 很 辛苦 那种 看不见 、   身体 上 、 精神 上 、 人际关系 上 、 学习 上 、 感情 上 、 面对 未来 那种 无力感 感觉 很累 好像 撑不下去 亦 拼命 自我 救赎 挣扎 不想 很 煽情 去 安慰 安慰 会 软弱 肆无忌惮   不 受 控制 一个 人 都       展开 全文 c 
 