此身_长安: ／ 感觉 问着 白痴 ／ 感觉 眼睛 哭 瞎 ／ 内心 真的 千疮百孔 — — 依然 做出         信 美丽 样子 去 面对 明天 面试 — — 两         张 不想 脸 — — 彼此彼此 ／ 好 想 都 不想 好好 睡一觉 ／ 撑下去 不 还要 撑 多久 还 撑         多久 想 死 觉着       展开 全文 c 
 C曹庆Q: 减肥 打卡 第一天 好 饿 啃 几个 水果 + 两个 火腿 期待 明天 到来 吃 东西 预感 一个月   估计     撑不下去 ！ ！ ！ ！   
 小小的小蔓蔓的蔓蔓: 承认 我过 一点 不好 很多 真的 都 熬 不   快要 崩溃 不 压力 改变 都 太 好多 事情 真的 接受 不了   无力 抗拒 只能 哭 完 再 爬起来 老老实实 走 这辈子 从来 没 坚强 大小 坎 都 死 撑过去   孩子   长 点心   好   
 约翰尼德普颖: 感觉 撑不下去   
 棉花糖天空堂主: 宋仲基 颜值 撑 第八集 实在 看不下去 太 做作 、 太 难看 老年人 粉丝 骂 恕我直言   
 手机用户1015558935: 中午 阴差阳错 羊 外婆 都 赶回 家 点着 外卖 吃 午餐 外卖 菜 还 实惠 饭不多 盒饭 大概 二两 羊 外婆 倒 吃 完 一盒 半 盒饭 都 霸 蛮胀                   瞧 没用 真心 着急 多长时间 ？ 十年 ？ 二十年 ？ 撑 羊 羊 结婚 坐月子 ？ 羊 外婆 68 糖尿病       展开 全文 c 
 愛笑的眼睛elaine仙: 《 一首 urban   R & B 曲风 重 节奏 情歌 歌词 叙述 一段 爱情 走 尽头 甜蜜 只 剩 回忆 真爱 时间 蚕食鲸吞 还 存留 一丝 希望 愿不愿意 这份 爱 撑下去 ？ CoCo 歌声 抚慰 痴心人 心情 希望 感情 僵局 时 懂得 珍惜   
 糯米团子鸭鸭鸭: 永远 都 摊上 样子 犯贱 爸妈 快 饿死 房里 挺 不   真的 撑不下去 真的 饿死 房间 判刑 不好过   没事 有时候 想要 极端 自残 发泄   想 死 掉   摆脱 一点 痛苦   伤心   会 惩罚   痛苦       展开 全文 c 
 Ewailen: 睡 : 消防员 撕心裂肺 哭声 还 记得 努力 猫 阶级 : 记得 女孩 跳楼 前 消防员 说 谢谢 真的 撑不下去 苦苦 挣扎 那段 黑暗 时光 里 不到 一句 抓 
 一九sui: 撑下去 撑 七月 四号 十点 回到 宿舍 睡 下午 好累 好怕 脑子 不转   
 wbxsbywpa: 别人 睡觉   公交     怎样才能 坚持下去   好 害怕 撑不下去   
 四月荒年: 世界 样子 爱情 样子 真的 活 好 卑微 明明 段 感情 撑不下去 却 硬撑 爱 一个 字 说服 倔强 好 恨 没有勇气 放手   
 伱算阿貓还阿豿: 不忘 初心 九句 话 撑不下去   
 Gynnn君_: 国内 音乐剧 高贵 人 发展 不 不 公司 赔钱 做剧 撑不下去 暴躁 过气 选手 : naccifuckyouall : 晕 满嘴 自诩 高贵 恶臭 熏得 一个 激灵 竟然 高贵 人 看 音乐剧 三生有幸 
 易烊烊的冰淇淋: 梨涡 圆周率 : 不 优酷 刷 街舞 这烂 节目 视频 不 给予 热度 看千玺 只 看 cut 到时候 贵 节目 还 高 热度 做 贵 节目 您们 所宠 几位 队长 粉丝 节目 撑 多久 ？ 
 叶幸运和叶小宝的故事: 换个 乐器 多事 接下来 多集 想想 片头 片尾曲 场景 撑下去 说 不 看 时 真香 他俩   锁住 毕竟 演员 拍 很 辛苦 
 小呆鱼儿爱吃糖LittleSun: 叶 幸运 叶 小宝 故事 : 换个 乐器 多事 接下来 多集 想想 片头 片尾曲 场景 撑下去 说 不 看 时 真香 他俩   锁住 毕竟 演员 拍 很 辛苦 
 -不要乱来: 才 第一天 感觉 撑不下去   
 ·樱花草莓星冰乐·: .... 孟 女士 真的 看剧 阻力 我快 撑不下去   
 你看树上有只猪也:   怜爱   想起 小朱 上半年 差不多 状态   真切 列出来 行程 安排表 明白 咳复   一个 感冒 拖 半年   骂 公司 不 做人 红 代价   偶像 不温不火 这一说   抠 脚   刀山火海 千难万难 撑下去 ギ リ ギ リ   
 Teresa高小亚: 夏天 却 扭过头去 看不见 理想 生活 之间 距离 不 明白 远 撑下去 K 理想 人 不 伤心   
 四三拍: 可爱 一夏   新 工作 目标 才能 撑下去 ！ 再来 立个 flag 老气横秋 爱 稳 静 滴 做 事情 干嘛   不 都 开心   将来 开心   
 杨小扬儿: 第一天   熬 发现 真的 撑不下去   
 丝莫尔青: 温情 吹笛 驭 尸 玩意 ？ ？ ？ ？ 加戏 就算 ！ 加江 澄 孟情 感情 戏 算了 ！ ！ ！ ！ ！ 魔 道 祖师 懂不懂 夷陵 老祖 第一 人好 ！ ！ ！ ！ 《 陈情 令 就算 肖战 盛世 美颜 jio 快 撑不下去 ！ ！ 孟子 义 这位 小姐姐 真的 赢 毁 魔 道 祖师   
 樂活的女人: zxc668   男人 唯唯喏喏 不吭声 妇人 叹 口气 道 放心 一日 夫妻 百日 恩 瘫 瘸 都 抛下 一个 妇人 这家 撑不下去 女人 说 说 呜呜 哭泣 男人 长长地 叹息 一声 道 小东 别哭 对不起 那心 留下 ？   
 yue_月上柳梢头: 都 不 掉 面霜 两天 一大 坨 怀疑 撑 不到 结束   
 赵湘云11596: 这是 ？ 好 艰难 快要 撑不下去   2 绵阳   
 琪敏周敏琪: 好累 好 累   精疲力尽 快要 撑不下去 转念 一想 说声 加油 ！ 希望 明天 ！   
 黑狗基尼: 撑不下去 认输 认输 再 求求   
 -GucciGaga: 晚上 两点 睡着 好 辛苦 撑不下去   
 最没有原则的仙女: 真的 太 烦躁 太委屈 撑不下去   
 萱草杂声: 海拔 4500 米 徒步 八公里 山路 身体 不听使唤 头痛 欲裂 康巴汉子 西绒 跳 下 山坡 掰 一根 树枝 说 拐杖 真 不行 背 我能 背得动 三百斤 ... 想 倒下 没事 有人 会 背 快 撑不下去 却 想 怎能 趴下 撑 山下 人 背 下山       展开 全文 c 
 小丫头和蓝星星: 我快 撑不下去 要死   
 眼镜怎么就坏了呢: 撑 大概 两个 星期 不得不 承认 网剧 橘生 淮南 真的 令人 失望 剧版 暗恋 导演 东宫 导演 看过 东宫 真的 危机感 真的 想 站网 剧 都 看不下去   
 文丽妮子: 撑不下去 心情 烦躁 迷茫 就读 一遍   1 清醒 时 做事 糊涂 时 读书 大怒 时 睡觉 独处 时 思考 2 再 难 再 好 淡泊 再 差 再 节省 3 路 不必 别人 标准 框定 人生 4 才华 撑 不起 野心 时       展开 全文 c 
 MiaoKingg: 好累 撑不下去   
 戏人老朽: 哥哥     都 近乎 崩溃 状态 下 度过     都 问     我能 撑下去     我能   支撑力 太小       选择     逃不掉   别人 每替 惋惜     更 疼       想想     我会 好受 点         （ 希望 不 小心 掉 进 沼泽地     明年 走 花路 ） 
 碎碎念的瓶: 妈妈 想 留在 家 却 一口 否决 安稳 生活 样子 大概 不 排斥 想 看 外面 世界 真的 撑不下去 再 回家 还 年轻 容错 成本低 再 努力 真的 努力   
 Okasiaaan: 啊啊啊 真的 好累 好 无力 真的 快 撑不下去 加油 更好 重聚 疏远 更好 我会 慢慢 走向   
 Bacchus财务IvanWu: 转     天天 快报   《 浙大 博士 跳江 自杀 孩子 撑不下去 15 张 照片   ! 生活 不易 人 睁开 双眼 便 咬牙 撑过 今日 份 痛苦 依然 坚强 想 一死了之 看着 疼爱 人 咬牙 撑   O 微信 扫 一扫   下载 天天 快报 客户端   
 晓玲200509: 六月 太阳 很烈 空气 中 飘过 一阵一阵 夹杂着 汗臭味 热风 晓月 傻傻的 站 学校 操场上 太阳 火炉 炙烤 脸上 滚落 不 汗水 泪水 神情恍惚 快 撑不下去 倔强 不   2 广州   
 丁丁dinghaiyan: 新人 很多 不 基本权利 维护 导致 压力 很大 情况 变得 很 糟糕 精神 不好 身体 撑不下去 说 还 惭愧 想 一个 小朋友 上课 老师 说 想 上 厕所 年纪 大小 提出 合理要求 都   
 一霎灯前醉: 太 难看 太 难看 靠着 帅哥 颜值 都 快 撑不下去   
 炸裂队长: 现金流 事儿 太 这是 创业 公司 最 看重 一点 公司 无论如何 都 一个 始终 赚钱 项目 保证 月 都 稳定 资金 输入 才能 调整 业务 规模 公司 营收 项目 不 稳定 员工工资 、 办公 开支 维系 撑 不了 几个 月 撑不下去 很多 公司 都 死 没 钱 路上       展开 全文 c 
 想取个名字叫可乐: 撑不下去   
 今天也要愛老何: 撑不下去 想 妈换 手机   还 撑 ！ ！ ！ ！   
 云吞汐: 水 森林 真的 看不下去 开场 半小时 后 一次次 看 表 感到 头大 想要 离场 硬撑 看 完 矛盾 转折 高潮 在我看来 戏剧 色彩 听 演后 谈 反而 感觉 演后 谈比剧 更 价值   看剧 多年 第一次 理论知识 撑 不起 荒诞派 台词 表现 哲理性       展开 全文 c 
 S九尾妖狐: 摊上 婆子 倒 八辈子 霉 ！ 不 想带 孩子 离开 感觉 撑 很 累 ！   
 盐不甜芝士: 撑不下去 再多撑 一点 背完 早上 结束 每次 都 终点 旁边 死 掉 学期 努力 全都 水中 月 踩 一脚 碎个   
 集藏月亮-: 小 郑   濒临 极限   撑   使 不至于 倒塌   姿势 维持下去   好 难受 好 委屈   
 记住我叫你二哥: 写给 [ 转发 ] 九句 话 撑不下去   
 准合口味: 日常生活 中   迫切 寻找 精神支柱 爱豆 过日子 一点 小事 都 撑不下去   会 想想 爱豆   音乐   品格   铸造 一个 理想 榜样   完美 榜样     爸妈 没少 支持   我妈 太过 支持   希望 我能 开开心心     有太多 烦恼   身体 健康   都 吃得饱 饱       展开 全文 c 
 冰镇西柚蝙蝠派: 热 搜去 看 些 恋爱 剧 好几部 第一集 都 撑不下去 无论是 校园剧 校园 延伸 职场 剧 一部 剧 男主 调换 违和感 都 一个 模板 纸片 人 真实 口区 电视剧 市场   
 喵性女孩P: 睡 : 消防员 撕心裂肺 哭声 还 记得 努力 猫 阶级 : 记得 女孩 跳楼 前 消防员 说 谢谢 真的 撑不下去 苦苦 挣扎 那段 黑暗 时光 里 不到 一句 抓 
 布莱斯的女孩: 真的 想到 鸡条 会 拆散   特别 难过   鸡条 唯一 真心 追 综艺   最 死撑 看 10 分钟 看不下去 
 Teresa高小亚: 夏天 却 扭过头去 看不见 理想 生活 之间 距离 不 明白 远 撑下去 K 理想 人 不 伤心   
 别說wanan: 这才 理想 恋爱 水到渠成 话题 顺其自然 走向 恰到好处 陪伴 自然而然 情话       喜欢 东西 会 想着 买 有趣 事会 想着 分享 想 不分场合 随时 打电话 困 告诉 想 睡 不用 撑 陪 日渐 相处 过程 中 喜好 性格 包容 改善 对方       展开 全文 c 
 __子昆: 真的 懒得 纠结 一口 薯片 卡路里 反正 姥子 长 样子 胖点 瘦点 都 没 影响 一张 胖脸 先胖 本身 婴儿 肥 初中 九 十多斤 是因为 学校 饭菜 太差 全靠 苹果 撑 饿 14 岁 一米 五五 九十斤 饿 十七岁 一米 五七 一百多 不 数字 踏踏实实 好好 吃饭 长起       展开 全文 c 
 学森201509: 东叔 成名作 总 有种 读 不 感觉 反而 不 著名 倒 读 津津有味 撑下去 也许 很 好看   
 谁的你若盛开清风自来: 撑不下去 丧 不 说 迷茫 自责 无助 真想 分担 纠结 事 麻烦 别人 都 鸡血 自我 麻醉 啥时候 结束   
 阿戳阿阿阿: 再 吐下去 我怕 撑 不到 张颜齐 21 岁 生日   
 昆明Hers半永久培训-yoyo: 一个 创业者 都 故事 年 感觉 快要 撑不下去 时刻 回过头来 看 都 珍贵 礼物 抱怨 畏惧 未来 女人 经营 好 取悦 更 vx15924880008             — — HERS 半 永久 培训   
 Yiguasumlp: 事实证明 男人 撑 不起 心情 无论怎样 都 开心 不 年 感到 开心 几个 时刻 无一不是 学业 顺利 时刻 工作 不太 顺利 碰到 人 都 很 难 笑 这条 路太难 撑下去 孤独感 吞噬 再 想要 关系 走 太 偏   
 轻眸随叶: 啵 丝 啵 啵 啵 : 睡 : 消防员 撕心裂肺 哭声 还 记得 努力 猫 阶级 : 记得 女孩 跳楼 前 消防员 说 谢谢 真的 撑不下去 苦苦 挣扎 那段 黑暗 时光 里 不到 一句 抓 
 灵魂归墟: 感觉 生活 撑不下去 想想   还 撑下去 
 三两合欢: 高中 用过 一个 软件 湖畔 模式 很 舒服 app 说 下架 下架 零星 导出来 数据 忘 用米 田 真的 换 手机 必备 app app 苹果 手机 定期 上线 刷 更新 看遍 开发人员 介绍 担心 运行 会 将来 撑不下去 还 发过 信息 感谢 辛苦 加油 
 重新遇见了你: 我快 撑不下去 开心 不 开心 装作 开心 在乎 人 就要 吵架 扬言 离开 ？   
 二点五次元涵OAO: 从来 学期 快要 完时 撑不下去 崩溃   
 橦執: 難自渡 : 撑不下去 只想 奔赴 朋友 怀抱 里 都 说 都 不用说 喝酒 吃火锅 都 治愈 
 京红领: 中美 两国 建交 40 年来 发展 成 我中有你 你中有我 离不开 状态 有时候 生气 吵架 样子 挺 吓人 很快 会 烟消云散 都 长期 撑下去 紧张 关系 中国 国家 经贸关系 交恶 交恶 很 长时间 都 很 难 恢复正常 话 中国 加拿大 关系   
 __大L: 立着 一个 做饭 形象 偶尔 炒 一个 菜 会 赞不绝口 撑 一个 能带 孩子 形象 从带 一个 升级 带 两个 却 从来 一句 辛苦 都 换 不到 ... 生 娃 跪 带 每每 天天 都 细小 事情 压 筋疲力竭 朋友 聊天 解压 宽慰 说       展开 全文 c 
 用户6846078303: 约 吃 甜品 看 电影 始终 进一步 动作 连好 几次 碰到 手 都 牵 天下 小雨 撑 伞 散步 想 笨蛋 不 主动 ？ 路过 小桥 时 折起 伞 扔 河水 里 愣住 笑 说 一个 人 淋雨 恍然大悟 咻 一声 伞 扔下去   
 密密麻麻在心口难言: 最 可怕 不动声色 崩溃 一层 薄膜 包裹 黑色 浓浆   一句 话 一个 字   力量 我快 撑不下去     好   
 Fay我是费依: 陈情 令 孟情 令 第三集 不 打算 看 玩意 薛洋 鬼 夷陵 老祖 修鬼道 操纵 死人 开山鼻祖 干嘛 薛洋 加戏 ？ ？ ？ ？ 蓝氏 双 璧 都 丑 ？ ？ ？ ？ 蓝曦臣 个素 人样 蓝忘机 两眼 无 神 一副 没 睡醒 样子 配音 撑 看 仙家 云梦       展开 全文 c 
 顶级难泡玫瑰茶: 日常 纠结 买手机   手机 撑不下去 不想 修   立马 换 不了   XS   MAX   XR 8P 之间 纠结 喜欢 8p 拍照 效果   据说 打游戏 很 流畅 众多 测评 里 表现   总 感觉 买 新 不 买 旧   怕 Xs   max 信号 不好   变砖   毕竟 价格 不 便宜   大 重 喜欢 白色 xr   信号 不 咋办         展开 全文 c 
 青春有张不老的脸01: 真 吃 不     肚子 撑   
 明少Harry: 电影 里 说 之间 无缘 分 全靠 死撑 明白 这话 直抵 泪点 却 说白了 爱 一个 人 真的 一个 人 事儿 拿出 过日子 态度 还 想 大不了 哭 一场 硬着头皮 爱 世间 缘分 不 缘分 都 撑 — — 七 堇 年   分享 单曲   K 花儿   ( 电影 《 那时花开 片尾曲 )   (       展开 全文 c 
 Elvira潘朵拉: 从小 有人 告诉 坚强 女孩子 自强 自立 人 告诉 撑不下去 再撑 忙 看病 都 没 时间 人 工作 再 努力 loser   
 Aimeego: 身体 耐心 都 快 临界点 撑不下去   
 江南肚才: 坚持下去 不 轻言 放弃 ！ 
 还还还阿蛮: 很多 真的 都 熬 不   快要 崩溃 不 压力 改变 都 太 好多 事情 真的 接受 不了 无力 抗拒 只能 哭 完 再 爬起来 老老实实 走 这辈子 从来 没 坚强 大小 坎 都 撑过来   
 公証人: 撑不下去   
 蔡長壮: 感觉 一个 深闺 怨妇 见到 不 抱怨 还 不少 相比 人 聊天 更 倾向 怼 人 骂人 想 吐 槽 一天天 上课 课 内容 大于 意义 可过 这阵儿 意义 大于 内容 第二次 重来 那种 感觉 快 撑不下去   
 灿妹儿canmeier: 才 没用 垃圾   诊断 出患 癌症 医院 天 台上 自杀 劝 哭 说 : 医生 都 说 康复 几率 微乎其微 不想 将来 病重 受苦 亲人 撑不下去 ！ 我爱你 放弃 ！   
 妈粉扛把子: 受不了 受不了 就算 俩 男主 都 撑 不下 看 ！ ！ 问 一句 剧版 温情 去 死 ？ ？ ？ ？ ？ 
 yuanyuanyuanyuanyuan-: 吃     撑 坐 不   绝望   
 大白兔小先森: 有时候 真的 不想 撑下去 想到 在家 平安 回来 会 想 办法 坚持下去   
 暴躁网友佐佐木: 同理 学生 撑不下去 选择 休学 休学 未来 反而 明朗 亀 梨 穿 毛衣 等于 杀人 : 转发 微博 
 serendipity0506: 去 拉面 店     份量 价钱 正比 21 吃 一半 吃 不   .... 撑   
 -阳光小甜萱: 撑不下去 很 难过 很 担忧 周二 周三   
 短腿的快乐小癫子: 撑不下去   
 pochiiiii: 六月 目前为止   大学 最苦 一个月   过边 吃饭 哭 中午   图书馆 差点 崩溃 中午     睡眠不足 脸色 暗沉 毫无 血色   一度 吃不下 饭   感受 不到 饥饿   姐妹 舍友 鼓励 撑下去   好 结束   说 很快   一个月 好 难熬   新 阶段   回到 回来 生活 轨迹     接下去 请 好       展开 全文 c 
 我是一只猫x: 总 肚子 上 肉 特别 坐 想 做 瘦 腹 运动 平板 撑 撑 不到 十秒 不 加上 天气 热 放弃 今日 瘦腹 运动 — — 失败   
 酱子吖516: 这部 剧 场景 切换 剪辑 真的 很大 ！ 港真 路 人 真的 看不下去 撑 真的 看忘羡 一博 打戏   
 Dl8whyy: 不想 再 拥有 墙头 想要 平常 持续 追星 不 想要 社交 有时候 人 说话 面孔 太多 不 撑下去 原以为 父母 身边 父母 中 top 前五 很 开明 那种 父母 被迫 发现 免不了 俗套 质疑 很 害怕 坏 情绪 自我 厌恶 缠 上身 做 一个 很 勇敢       展开 全文 c 
 晴雨剑: 压力 无形中 越来越 紧 本来 撑住 一件 小事 爆发 ！ 心情 不爽 到极点 ！ 刚刚 居然 宿舍 设备 极度 匮乏 情况 下 马桶 整通 好像 事 都 豁然开朗 ！ 难受 过不去 坎 马上 就要 成功 前 障碍 期待 事 努力下去 肯定 会 好 ！       展开 全文 c 
 无常君cr: 看不到 一丝 阳光 乌云 一层层 不停 叠加 还 撑下去 未来 我会 人 好 想 问问 生活   
 _Pundarika: 说 给予 恩惠 偿还 会 很 麻烦 很 怕麻烦 大多 事情 好 实在 撑不下去 会 找 帮忙 （ 也许 静静 等待 自我 毁灭 ） 讨厌   
 小骄傲的专属FD: 感觉 得不到 安全感 真的 累 好 累 打起精神 面对现实 面对 真的 撑不下去 不 ？ 有时候 冥想 到底 活下去 ？ 来到 世界 上 使命 ？ 累 就要 永远 休息 家人 朋友   
 爱笑又爱哭的小雯子: 人生 总有 一段 孤独 走 时光 理解 撑下去 好   
 吴冰雹:  studyaccount         高二 总算 结束 快到 期末 简直 快要 撑不下去 感觉 身体 快 支撑 不住         考完试 很多 事要 去 做 希望 高三 生活 顺利   
 _木棉姑娘__: 下半年 第一天 放假 倒计时 2 天 （ 真 撑不下去   牙疼 腰疼   sa 叭 前 几天 吃     火烧 牛肉 馅 太太 太足 万年 点 奶茶 不 动脑子 人 终于 尝试 新品 （   幽兰 四季春   蛋糕 刚刚 考完试 心情 变得 好好 滴 维他 奶   太 可爱 拍 可爱 滴 轻食 外卖               展开 全文 c 
 Tronrto: 舍友 陆陆续续 身体 小毛病 一个 喉咙痛 一个 感冒 发烧 第一 时间 去 解决 拖 想想 高三上 学期 明明 感觉 发烧 感冒 无力 持续 几天 硬是 感觉 还 撑 撑 药 不怎么 吃 撑 一个 星期 才 好 鬼 身体 熬过 高三 下学期 喉咙 发炎 连续 几天 越       展开 全文 c 
 汉澳sinox2013-李炎: 回复 0 点 _ 童话 : 投降 ？ 评论 锋芒太露 人 打击 赖 ？ 评论 不 ？ 中兴 不服 美国 去 支持 伊朗 罚 十亿美元 乖 只 小狗 敢 保证 华为 不 走 中兴 老路 ？ 再 看 极力 吹捧 华为 会 投降 撑不下去 会 投降 曲线救国 公司 去 撑 伊朗 本身 错 公司 
 九八不动产周刊: 经济型 可靠性 低噪音 三个 都 不 协和 撑不下去 京畿 盗图 大 魔王 : 边境 计划 firefly : 有钱赚 麻 
 blueblueskyyy: 过程 狗血   先 试试看 ! 会 固步 不前 好 ! 这段 关系 里 撑不下去 希望 勇气 走开 希望 成长 过分 伤心 贬低 坚信 值得 爱 一个 可爱 姑娘 希望 过分 依赖       展开 全文 c 
 MR-mortimer: 族长 夫人   : 宇宙 花火   : 呆 社保 Alox   : 店里 熊   : 喵 桑 学习   :   甜食 魔宴   : 荆不疑   : 用户名 拒绝 显示   : 清欢 重 生于 海 伯利安   : 穆人 卷   :   努力 猫 阶级   : 记得 女孩 跳楼 前 消防员 说 谢谢 真的 撑不下去 苦苦 挣扎 那段 黑暗 时 
 潘小胖要天天开心: 过不下去     车该 开   喜欢 摄影 学   工作 撑   ...... 着急 慢慢来   着急   慢慢来 着急   慢慢来 想要 都 会   
 吖咩咩-: 不想 复习 看 不 进去 背 不 进去 还 没 背 完 考试 竟然 撑不下去   
 一只脾气暴躁的小火龙: 养成 一到 下午 四五点 困到 灵魂 出窍 不 睡觉 撑不下去 习惯 ？ ？ ？   
 -萱的王-: 想念 p3 好 皮肤   很少 长痘 满脸 闭口 痘痘 图书馆 说 再见   朝九晚 十坐 一个 星期   屁股 都 快 坐平   考试 都 撑不下去   假期 快乐   
 FREEDOM平: 太 心声 太 真实   貴方 と の 時間 は   い ま や 夢 の よ う   etnw 两年 半   想到 收录 live 都 收录   疯狂 流泪   怀疑 到底 去 看 一切都是 臆想 梦 数着 能见 日子 撑下去   还 高强度 追 多久   最 喜欢 solo   live   出张 碟 求求   说 都 烦 
 梦瑶小可爱-3-:   啥时候 娶 结束 异地 恋有 好 几次 都 撑不下去 看 哭   L 梦瑶 小可爱 - 3 - 微博 视频   
 秋名山车神刚就易阵风: 做 完 英语 窝 桌上 快要 撑不下去 圆圆 圆肚肚 : 下课 添 福宝 伪 阿姨 助攻 组 : 500 早上好 困 
 氟西汀Fluoxetine__: 真的 撑不下去 头疼 好 几天 熬夜 昨天 通宵 考试 都 后天 护导 书 依旧 白白胖胖 我该 好 想 回家 我要 不行   
 沙雕小兄弟: 感觉 快 撑不下去 灰心 更 糟心 事儿   
 宋城希CheneySong: 算算 這是 第四次 參加   越野跑 第三次 參加 25 公里 首次 挑戰 15.7 公里 獻給 merrell   水返 腳 兩棲 越野跑     很 幸運 都 平安 順利 完賽     ( 當然 受點傷 對 來 說 都 ) 兩年 後 回到 起點 這次 選擇 征戰   25.7 公里               老實 說 從 來 沒想過 我會       展开 全文 c 
 颖颖会飞: 承认 我过 一点 不好 很多 真的 都 熬 不   快要 崩溃 不 压力 改变 都 太 好多 事情 真的 接受 不了   无力 抗拒 只能 哭 完 再 爬起来 老老实实 走 这辈子 从来 没 坚强 大小 坎 都 死 撑过去   
 安利菌: 拍可孚 都 囤 一个 小时 抢 几万 件 库存 ！   2 片装 只 剩下 8 千件 ！   刷新 掉 好几件 速度 估计 撑 不了 多久 还 想 囤 快   安仔 翻 下 评论 大部分 蛋仔 都 好用 肤质 感 般的   蛋仔们       展开 全文 c 
 木木是只小馋猫: 老子 连约 好 小姐姐 都 没 去 医院 陪 三天 治疗 猫 瘟 敢 撑不下去 老子 绝逼炖 野猫 野狗 ！   
 我姓李却不能li你: 此时此刻 心情 难以 言语 表达 不 关系 多久 真的 爱 不 上 表现 ？ 对不起 真的 看不出来 爱 都 说 孩子 撑 下 有时候 真的 撑不下去 不 欠 一个 男人 不 承受 应有 担当 ？ 事 都 老婆 计较 唯一 一点 证明 人       展开 全文 c 
 Mongsin: 快要 撑不下去 
 -ORANGECJ: 象山 影视城   29 号 自驾 一波 去 象山 影视城 无奈 30 号 一波 强降雨 心疼 全湿 掉 yeezy ... 还好 景区 边上 有个 剧组 超市 还 挺 实惠 买 双拖孩 15 块 撑起 游玩 信心 景区 门口 吃饭 不贵 都 价格 景区 后 便利店 都 无人 便利店 感受 科技 先进 那种 小黄       展开 全文 c 
 ViolaXuHao: 撑不下去 休息 休息 ！ （ 做 梦 银行存款 你配 ？ ！ ） 妖 妖小精 : 吃 好 睡 好 天天 拉粑 粑 ～ 
 单Genius: wow 看 韩剧 啊啊啊   听见 声音 简直 消除 韩剧 偏见 .... 最 讨厌 电视剧 感觉 bbbbb   感觉   妈   绝   太棒了   简直 爱死 李宝英 姐姐  李宝英 李钟 硕 腿   尝试 看 太阳 后裔   第五集 撑不下去 ... 感觉 太 无聊       展开 全文 c 
 用户6170208265: 中国 失踪人口 档案库 官网 : 回复 平安 随州 : 儿子 快 回家吧 妈妈 撑不下去 ！ 爸前 几天 出车祸 紧急 救治 刚刚 脱离 危险期 哀怨 查看 图片   平安 随州 : 随警 提示   请 扩散 ！   
 袁子袁邦: 人 说 异地 恋 会 分开 异地 恋 不 等同于 分手 坚持下去 世界 上 跑 赢 时差 撑 距离 爱情   
 一个非常隐秘的大号: 撑不下去 请 回头 父母 请 很 爱 请 撑住 请 开心 请 开心   
 查無此人sor: 金秀贤 正式 退伍 九句 话 撑不下去   
 派大星你好呀1: 快乐 不   20 岁 只 阳历 生日   是因为 真的 33 岁   一无所有   还 负债   大概 我活 最 凄惨   乐观     健康 负累   都 撑不下去   真的 一无所有   都     美好 东西   好 感情   越 贫穷 越 不堪   越来越 累   说句实话   想到 死 解       展开 全文 c 
 随意吐槽的小透明: 百度 一个 百度 前 阵子 内容 全都 清空 还 发消息 催 去 签到 不 去 签到 还 扣 分 还 恐吓 再 不让 做 主 奇 怪 不让 里 内容 做 主 干嘛 做 一个 白板 主 ？ 吃饱 撑 ？   
 悄悄地跟你说天慢慢亮了: 我快 崩溃 真的 撑不下去   
 你看树上有只猪也:   怜爱   想起 小朱 上半年 差不多 状态   真切 列出来 行程 安排表 明白 咳复   一个 感冒 拖 半年   骂 公司 不 做人 红 代价   偶像 不温不火 这一说   抠 脚   刀山火海 千难万难 撑下去 ギ リ ギ リ   
 藏起来的我hhh: 努力 克制 努力 控制情绪 努力 现状 往好 方向 发展 会 管不住 思想 情绪 安神 补 脑液 天天 喝 助眠 视频 一个 一个 看 不行 不 没人 懂 痛苦 说 矫情 压 真的 好累 好 累 白天 真的 控制 下 晚上 处于 崩溃 界限 撑 不下       展开 全文 c 
 _WekiNaNa_: 傻帽 孩子 脸   创意 真的 弄 不 SixYeDam : 放心 创意 都 是因为 帽家 孩子 脸 撑起来 
 不可以吃的包包: 上半年     剩下 半年 曾 很多 快 撑不下去   崩溃 掉 时刻 照样 走 经历 过太多 不 阶段   内心 变强 下半年 目标   先 好好 减脂     工作 先 做   至少 先 茶米 油盐   解决 温饱   
 小嚯嘿: 15.22   他来 ！ 考完试 诶 16.22   打了个 好大 哈欠 侧 趴下去 哈哈哈 好 可爱 16.38   撑不住 正 趴下去   脑袋 胳膊 上 动来动去 调整 姿势   毛绒绒 好 可爱 嗷 猜猜 睡 几点 ( 心理学 研究 方法 好难 背   知识 不进 脑子 ( ( 才 走神 观察   真的 背 不 进去 昂   
 用户6540427359: 厦门日报     厦门 本地 新闻     厦门 网     厦门 小 鱼网     农民工 不易 打工 只为 一点点 微薄 收入 老板 耍赖 工资 不愿 发放 十几个 人 做 厨房 集体 起诉 集体 申请 强行 执行 去年 一点 消息 都 整日 整日 法院 跑 没用 累 钱 确实 撑不下去 生活 压力 太 大 恳求       展开 全文 c 
 是吴Cheery啊: 续命 牛奶 下半年 好 一点 真的 快 撑不下去   
 小文的一生: 7 月 1 不到 六点 起床 早上 收拾 好 站 会 碗 吃完饭 收拾 屋子 很多 不必要 做 事 还好 早饭 合胃口 鸡蛋 咸菜 玉米 一上午 站   走   跑 干 干过 事 午饭 本来 想着 吃不下 一吃开 好像 吃 最 躺 撑 还 量 刚 合适       展开 全文 c 
 Yourbabypiggggggg: 撑不下去 真的 撑不下去 男朋友 电话 还 不通   
 二木木易: 撑不下去 心情 烦躁 迷茫 就读 一遍   1 清醒 时 做事 糊涂 时 读书 大怒 时 睡觉 独处 时 思考 2 再 难 再 好 淡泊 再 差 再 节省 3 路 不必 别人 标准 框定 人生 4 才华 撑 不起 野心 时       展开 全文 c 
 猫在撒娇: 都 撑不下去 早点 死 掉 拜托 拜托   
 灰色的时间521: 人生 百味 离合悲欢 苦笑 泪水 都 经历 一种 人生 一种 生活 一种 选择 里 都 多令 想象 不到 痛苦 无奈 难过 难是 难 总会 只管 努力 剩下 交给 时间 撑下去 ！ 结束 意味着 新 ！ 2019.7 1   2 北京   
 我有一只小喵喵: 人生 艰难 怕 撑不下去   
 南风未起XC: 实习 培训 第一天 听 很 绝望 不 九个 月 撑得住 都 很 想 说 去 看 一忙 没 时间 没什么 事 捯 饬 很 晚 再次 一个 陌生 环境 一周 总共 吃 六 顿饭 不饿 吃 不 减肥 瓢瓢 记得 按时 吃饭 睡觉       展开 全文 c 
 郑柏旭助理贾真真: 生活 有趣 永远 不 明天 会 到来 命运 都 提前 安排 好 希望 事情 永远 发生 祈祷 永远 努力 一塌糊涂 ～ 不愿 想 太 生活 太难 太 恶心 ～ 不 面对 还 ！ ？ 真的 撑不下去 生活 太 绝望   
 lemonlingo: - 累到 瘦 三四斤 到达 近几年 体重 最低点 再 感觉 身体 撑不住 别人 情绪 不 好吃 很多 焦虑 都 不想 吃 感觉 都 抛弃   
 芸儿44048: 承认 我过 一点 不好 很多 真的 都 熬 不   快要 崩溃 不 压力 改变 都 太 好多 事情 真的 接受 不了   无力 抗拒 只能 哭 完 再 爬起来 老老实实 走 这辈子 从来 没 坚强 大小 坎 都 死 撑过去     2 江门   
 出国劳务平台: 人生 百味 离合悲欢 苦笑 泪水 都 经历 一种 人生 一种 生活 一种 选择 里 都 多令 想象 不到 痛苦 无奈 难过 难是 难 总会 只管 努力 剩下 交给 时间 撑下去 ！   
 Stargazer空想家: 一个 资深 宅 与世隔绝 ？ 大火 巨人 喰 种 re0 实在 没 好看 没 看 看 几集 实在 撑不下去 弃 先说 巨人 军国主义 洗脑 根本无法 接受 喰 种 不 好看 说 题材 不 接受 确实 生存 猎奇 食人 都 写 烂 生存 real   account       展开 全文 c 
 追风少女森绘梨佳: 听说 上午 偷吃 猫 粮 撑 午饭 都 吃 不 ？ ？ ？ （ 肚子 撑 ）   
 这世界让你紧张害怕吗: 快要 撑不下去 53 天给 灌 一碗 毒 鸡汤   
 要每天开心的炸鸡柳: 承诺 永远 做 不到 真的 撑不下去   
 老坛握笔培训中心: 加油 加油 加油 加油 加油 加油 加油 加油 加油 ！ ！ ！ ！ ！ 再学 一个 星期 物理 永远 不学 ！ ！ ！ ！ 加油 加油 撑住 ！ ！ ！ ！ ！ ！ ！ 再有 一个 星期 离开 地方 ！ ！ ！ ！ ！ 做 喜欢 事情 见 想见 人 ！ ！ ！ ！ 撑下去 ！ ！ ！ ！ ！ ！ ！ ！   
 夜色酒庄: 诊断 出患 癌症 医院 天 台上 自杀 劝 哭 说 : 医生 都 说 康复 几率 微乎其微 不想 将来 病重 受苦 亲人 撑不下去 ！ 我爱你 放弃 ！ O 网页 链接   
 Klery007: 很多 人 不 刻意 见面   真的 见 不到 表面   放在 心底 喜欢 条路 走 很 不   撑不下去 想 尝鲜 想 缓解 却 无济于事 误解   感情 抹 去 埋心 苦笑 最 孤独 时光 塑造 对方 心上 有人 大可不必       展开 全文 c 
 能把快乐接我一天吗: 像是 集市 上 鱼   水分 蒸发 差不多   时常 快要 撑不下去   适时 吝啬 地洒点 水   便 再 提着 一口气 蹦 哒 两下   作出 生龙活虎 样子 看   前途 未卜 痛苦 周而复始   死   偏 不肯 温柔 豢养   
 汉堡很饿哎: 新宠 coco   早上 饿得 感觉 吃 完 一桌 喝 杯 豆浆 吃 四个 小笼包 吃不下 想着 浪费 碗面   愣 撑下去 半碗   难   
 雷哥哥和梦宝宝的日食记: 本来 一点 不 饿 看 蒋 阿姨 晒 午餐 饿 爆 还 买螺 狮粉 简直 大厨 距离 一包 方便面 佐料 差距 天气 天意 ## Hello 七月 ## 可爱 一夏   一个 火腿肠 吃 撑   
 戀丶哆: 定期 吐槽 一番 有助于 身心 放松 撑下去 甜味 少年 : 喜欢 几个 不着 调 老朋友   不 常见 面   有事 有空   没空 人间蒸发   感情 不 维系 足够 铁     
 YC-杨闯: zxc668   爹 拼下去 甘州 还 没 杨浩 居然 绕过 甘州 肃州 我肃州 好 欺负 ？ 多年 经营 好不容易 一块 地方 丢 肃州 龙家 还 去 ？ 拼到底 劳师远 征 兵员 接济 不上 粮草 耗费 更 巨 咬咬牙 撑下去 能撑 杨浩 退兵   
 普通退役熬夜员楽光: 不 65 高资 资深 撑下去 五月 青枫   : 93 级 ！ 不 62 级 高资   还 撑下去 
 徐家迷妹子-: 肯定 穿着 不合 脚 鞋子 苦 撑下去 早上 毅然决然 回家 换 双鞋 七月 苦尽甜来   
 记录无聊的日常: 放下 外 物 活 开心 一点 感觉 我快 撑不下去 假装 开心 真的 很累 没人 懂 很 累 感觉 一个 极端 陷入 一个 极端 亲情 、 友情 、 爱情 都 不在乎 好   
 哀喜0813: 水深火热 不 捕获 朋友 父母 只言片语 安慰 还 再 往前走 变得 厉害 一点 有人 背后 苦苦 撑   
 夏小末嘚小屋: 不 30 年 活 撑不下去   2 晋中   
 略略宝Y: 努力 快乐 总有 最 亲近 人 最 沉重 打击 也许 有天 撑不下去 真的 解脱   
 valeriantaker: 周末 看 两天 书   昨天晚上 撑不下去 十点 睡   定 6 点 闹钟   没 每节课 阅读 量 电脑 上 死 都 看 不 进书 习惯   明年 选 课会 死   九月 回来 还 再 研究 研究 课     
 密码0216: 坚强 男人 撑不下去 会想 妈妈 想 妈妈 哭 想 回家 诉说 妈妈 一个 灵魂 港湾 内心 无处 安放 委屈 寄托 世界 没 世界 到底 善良 无情 吞噬 孝心 物质 磨灭 友情 利益 绑架 爱情 角落里 哭泣 世界 会 好   ( 未来 版 )   [ Live ]       展开 全文 c 
 ATsurreal: 一张 专辑 都 不知 反复 听 遍 都 数不清 1989 reputation 陪 度过 最 难受 快要 撑不下去 red speak   陪 度过 最 无忧无虑 fearless 里 穿着 长裙 公主 女孩子 美好 定义 都 太 珍贵 漂亮 孩子 抢走 张图 绷 不住 
 用户6713632229: 7.1 说 再 生气 情绪 都 再 跟着 走 撑不下去 不再 生气 前提 再 想着 容许 再 任性 升职 酒 参与 我怕 人 喝 交杯酒 我会 难受   
 情話心說: zxc668   男人 唯唯喏喏 不吭声 妇人 叹 口气 道 放心 一日 夫妻 百日 恩 瘫 瘸 都 抛下 一个 妇人 这家 撑不下去 女人 说 说 呜呜 哭泣 男人 长长地 叹息 一声 道 小东 别哭 对不起 那心 留下 ？   
 叶幸运和叶小宝的故事: 换个 乐器 多事 接下来 多集 想想 片头 片尾曲 场景 撑下去 说 不 看 时 真香 他俩   锁住 毕竟 演员 拍 很 辛苦 
 逍遥小猫酱: 昨晚 篇文章 单位 团购 蛋糕店 撤店 南京 最 热闹 中心 俗称 暴利行业 蛋糕店 做 不 想起 团购 时 问及 店长 上 一个 蛋糕店 为啥 撤走 说 生意 难 做 说 估计 撑 多久 说 十年 没 两年 跑 原因 依旧 生意 难 做 ！ 房租 付不起 ！   
 -Sherlockkkk: 我球球 西兰花 赶紧 出 BDCDDVD 行不行 只靠 前三刷 记忆 我快 撑不下去 
 想变幸运的女孩kk: 坤音 一点 危机意识 都 青营 一播 走 一批 粉丝 cql 一播 肯定 还要 走 身边 都 鲜活 例子 拜托 好好 营业 新粉 吸 不了 老粉 还 走 一大堆 还 撑下去 看不到 未来 最 失望 一点 不 还 多久   
 嘟嘟说要做自己:  锦衣 之下 想 忘记 煎熬 还 七月 锦衣 会 ？ 一个 理由 快 撑不下去 O 网页 链接   
 张啊啊啊啊艺: 55 分钟 撑不下去 睡觉 第十四 年 酒肉朋友 狐朋狗友 塑料 姐妹 XLiHNNiu   祝 开心   
 sunXkun: 好 快 都 下半年 半年 好像 等待 中 度过 包括 刚刚 癫疯 之夜 苦 快 一个月 都 崽 崽 很多 事 工作 很 忙 猫 生病 离世 大大小小 烦心 事情 都 快 撑不下去 好像 还行 份 割舍 依赖感 反而 更 勇气 面对 事情       展开 全文 c 
 打个摩的见花花: 人 不 中途 弃剧   shn     再厚 滤镜 再 撑下去   
 逃避诗: 真的 一段时间 放空       快 撑不下去         
 世界末日女朋友ii: 撑不下去   道别 罪   
 林子薇薇V: 很快 就要 撑不下去   
 LXLDBYBJ: 一只 静江 : 真的   咖啡 感觉 撑不下去 
 Anna玉儿: 都 坚持下去 理由 
 EdwardFun520: 人生 真的 一场 游戏 每名 玩家 开局 抽个 大礼包 人 抽到 金币 人 抽到 999 满级 段位 低 大神 带飞 段位 提高 打怪 难度 随之 增加 升级 之路 人 技术 人 充值 玩家 撑不下去 会 或早或晚 选择 离开 游戏 退出 都 为时尚早 ？       展开 全文 c 
 昊啾啾_: 好像 真的 快 撑不下去     
 帐中妖和枕边猫: 走 人 一个 不 走 该留 人 撑不下去   
 七月的米巫婆: 今日 监考 同事 哭穷 说 去年 买 一套 一百八十 平 房子 后 没 钱 转瞬 说 实在 撑不下去 就让 老爹 老妈 老家 五 套房 卖 一套 好   
 要努力考上研究僧的禾: 回归 大三 说 再见   经历 一个月 期末 复习   考试 周   课设 周   熬 两个 星期   通 两次 宵   算是 通 一夜 去 验收 课设   放 几天 假   一个 学期 完完整整 放过 假   不 真的 撑不下去   一个月 真的 折磨 放假 好 快 落 ！ 好       展开 全文 c 
 鸭鸭鸭血大魔王: 撑不下去   药 吃 心慌 难受 不 陪 聊聊天 再 睡   真的 没人 爱   
 文酱很靠谱: 快 撑不下去 好 一点 ！ ！ 
 安安的火树琪花: 宝贝   听 说 很 辛苦 那种 看不见 、   身体 上 、 精神 上 、 人际关系 上 、 学习 上 、 感情 上 、 面对 未来 那种 无力感 感觉 很累 好像 撑不下去 亦 拼命 自我 救赎 挣扎 不想 很 煽情 去 安慰 安慰 会 软弱 肆无忌惮   不 受 控制 一个 人 都       展开 全文 c 
 繁华6143121420:  晚安 语录 人 独自 前行 任何人 都 帮不上忙 再苦 再 难 撑下去 有时候 真的 想象 还要 强大 微博 贴纸   
 子薇格格wei: 倒计时 day14 学校 里 撑不下去   宿舍 风扇 坏 一年 报修 好 几次 都 说 修 只能 换   夏天   早上 四五点 热醒   一身 汗   每天晚上 会 断电   小 风扇 电能 充 不了   脆弱 睡眠   四五点 醒 再也 睡不着   白天 上课 好困     贼 烦人   磨 不想 吐槽   
 宋大大大大大楷: 逃避 才 世界 上 最让人 上瘾 东西 压力 大到 撑不下去 认定 方向 终点 崩溃 语无伦次 所有人 恶语相向 朋友 都 搞 丢 越 想 活得 样 却 发现自己 连狗 都   2 济南 · 山东大学 兴隆山 校区   
 蔡徐坤什么时候开演唱会: 七万块 债务 还 差 三万 五再 熬 两年 反正 还 钱 用钱 人 还 钱 人 有时候 真想 换个 爸爸 无数次 撑不下去 怕疼 跳楼 死 太 难看 上吊 舌头 伸 太长 吃 安眠药 死不透 算了 能活 记得 好 傻 第一份 工作       展开 全文 c 
 和十二一起睡觉: 我快 撑不下去   
 喜欢我你不会吃亏的: 真的 好苦 我快 撑不下去 爸爸妈妈 都 去 医院 陪 外公 没 空管 前 几天 打电话 说 老年痴呆 症状 回去 不 扁桃体 发炎 还 低烧 好 难受 胃里 不 舒服 中午 喝 几口 粥 吐 大三 还要 分 方向 想选 网络 家里 不让 人 做主 份 小学       展开 全文 c 
 Paco_Yao: 那次 冒险 半夜 上山   争拗 中 队友 不想 撑下去 尝尽 自由   感到 没趣   今日 推荐 《 任我行   -   陈奕迅 很长 时间 里 单曲 循环 歌 曲风 很 顺畅 一气呵成 感觉 之外 歌词 真的 很 值得 细细 去 琢磨 歌词 里 主角 从小 固执 倔强 追求 自由 长大 后 慢慢 学乖 变得 不再 勇敢 开       展开 全文 c 
 ZL小皮孩儿咯咯咯: 拼 尽全力 努力 效果 都 不及 别人 万分之一 太 愚蠢 ？ 撑下去 好 难受 我怕 再也 阳光 想 做 不到   
 是一只菜呀: 抱 刚 买 奶盖 茶 摔   胳膊 撑 怕 奶盖 撒   直挺挺 跪   膝盖 上 好大个 疤 
 国际贸易茶马古道茶友会: 福慧 五台山 大智 文殊院 事情 发生 2018 年 十月份 浙大 博士 失踪 只 留下 一份 遗书 四天 后 钱塘江 打捞   浙大 博士 跳江 自杀 孩子 撑不下去 几张 图 ！   O 网页 链接   
 小绵龙的麻麻YanRAD: 初恋 追星 没想 初恋 不 进来 实际上 错过 苦撑 时期 越 越 喜欢 、 越 回顾 越 坚定 办法 ？ 只能 庆幸 走 
 用户6847326430: 诊断 出患 癌症 医院 天 台上 自杀 劝 哭 说 : 医生 都 说 康复 几率 微乎其微 不想 将来 病重 受苦 亲人 撑不下去 ！ 我爱你 放弃 ！   
 再也不吃螺蛳粉: 真的 不想 打扰 好 想 好 想 好 想 好 想 好 想 好 想见 残忍 混蛋 bxj 快要 撑不下去 知不知道 好 讨厌 好 想 打死 想 不肯 放下 世界 都 灰色 一个 抱抱 好不好   
 杨小轩6047275680: 持家 老铁     生活 压力 好大 手机 7 年   感觉 我快 撑不下去 
 用户6851256873: 约 吃 甜品 看 电影 始终 进一步 动作 连好 几次 碰到 手 都 牵 天下 小雨 撑 伞 散步 想 笨蛋 不 主动 ？ 路过 小桥 时 折起 伞 扔 河水 里 愣住 笑 说 一个 人 淋雨 恍然大悟 咻 一声 伞 扔下去   
 卞卞1995: 再次 上 用光 好运气 感觉 不到 余生 长 撑下去   
 lycorislonly: 確有 很多 更 艱苦 人 努力 生活 努力 過 這種 不想 活 無力 感為 什麼 還不走 不 去 看中 醫我媽 問醫生 吃 飯 沒 ？ 病人 這麼 很累 醫生 說 喜歡 事 運動 不喜歡 才 勞動 也許 他們 為 努力 人才 能撐 沒 說 後 父母 無動 於 衷 個       展开 全文 c 
 就是张小玲: 重庆 高估 肚量 一碗 小面 三碗 冰粉 一顿 火锅 吃 撑 还 计划 吃 一路 吃 不 洪 崖洞 新建 很多 商场 两年 前 记忆 中 街景 不   唯一 一个 来过 第二次 城市 十五天 行程 满满的 旅行 结束 回家 睡觉 去     
 一点自闭: 原创 剧情 撑 不起 剧 配角 加 多戏 看 全靠 忘 羡   2 厦门 · 厦门 北站   
 我的风筝在哪里: 好累 ~   感觉 快 撑不下去 默默 做事 一个 人 做 一个半 人 工作 功劳 全是 别人 领导 还要 嫌 不 做事 工作 做     身体 累 还 不算什么 都 心累 不行 崩溃 都 是从 心累 啥时候 撑不下去 崩溃 走 才       展开 全文 c 
 要你向我飛奔而來: 拒绝 别人   别人 就算 是因为 喜欢 撑 半个 月   成 定律   别人 长久 走   习惯   
 大白羊老徐: 想起 一个 笑话 前 几天 妈 去 楼下 买 东西 后 爸 楼上 喊 大 太阳 不带 伞 一把 透明 雨伞 哈哈大笑 问 老爸 意识 尴尬 说 撑 能遮点 我妈 带 爸 关心 真的 太阳 下撑 透明 伞 走   
 我是酸木瓜: 大 早上 拖起来 撑 伞 去 升旗 早起 傻 很困 一点点 都 复习 不 满脑子 睡觉   
 Motif米田: 老朋友 感谢 陪伴 三两 合欢 :   用过 湖畔 模式 很 舒服 下架 零星 导出来 数据 忘 用米 田 真的 换 手机 必备 app app 苹果 手机 定期 上线 刷 更新 看遍 开发人员 介绍 担心 运行 会 将来 撑不下去 还 发过 信息 感谢 辛苦 加油 
 不知名资深互联网网友在线冲浪: 朱一龙 太 好看 浓眉大眼 剑眉 星目 活过来 拢 龙 宝贝 不 营业 指望 军装 还 撑下去 朱一龙 
 略略宝Y: 努力 快乐 总有 最 亲近 人 最 沉重 打击 也许 有天 撑不下去 真的 解脱   
 开心的总总: 重启 挺 矛盾 剧 来说 不 信任 徐磊 喜欢 加 无关紧要 支线 就算 支线 演技 还 不好 又臭又长 看 撑 不 起剧 看 真 窝火 小说 来讲 真的 喜欢 这部 剧 大部分 角色 多部 想 看部 好 盗墓 笔记 好 小说 挺 希望 经典 剧作 ！   
 ___白石医生的抹茶pocky: 火箭 少女 101 _ 傅菁   小宝 你养   撑不下去   
 潘小胖要天天开心: 过不下去     车该 开   喜欢 摄影 学   工作 撑   ...... 着急 慢慢来   着急   慢慢来 着急   慢慢来 想要 都 会   
 法克low逼们: 吃 吃 大 面包 分 三次 吃 居然 一口气 两次 吃 完 撑 脚板 早上 不爽 压下去 难受 走路 多压 几下 舒服 点 保健 保健 买 神灯 天天 在家 热敷 按摩 膏   
 沙玛釰钬: 集市 上 鱼 水分 蒸发 差不多 时常 就要 撑不下去 适时 吝啬 地洒点 水 便 再 提着 一口气 蹦 哒 两下 作出 生龙活虎 样子 看   前途 未卜 痛苦 里 周而复始   死 偏 不肯 温柔 豢养 分享 单曲 K 心酸 （ 网易 云 音乐 ）   
 只只曉彭: 刚刚 好 搬 砖 一个月   我爸 每次 发 视频 都 会 问 有没有 钱   没钱 说   每次 都 死 鸭子 嘴硬 说 上次 还 说 不好意思 都 养 多年 大 不在乎 一下子 感动 实在 撑不下去     说 没 钱   我爸 给我发 两百   结束 没想到 隔 一小 会 连发 两个   我以       展开 全文 c 
 上海百济韩国语中心: 百济 韩国语 早安 百济             感觉 撑不下去 瞬间   最终 都 会     
 哎呀呀我还在等: 七月 你好   不再 我明 饮鸩止渴 却 甘之如饴 我怕 没 稻草 真的 撑不下去   
 甜甜荃儿: 终于 结束 一个月 学习   想想 前 几天 累 委屈   好像 好久好久   撑不下去 努力   天生 乐观   只不过 强迫 咬咬牙   早上 吃 不了 饭 只能 啃着 昨晚 面包   最 难过   好多 人 理解 不了 难 说 活不下去 转 锦鲤   背书         展开 全文 c 
 傲霜雪2010: 西城 SQL : 雾 霾 中服 雾 连个 撑 雨伞 人 都 木有 老婆 不 跑 去 美帝 一天天 烂 tinyfool :   穷国 无 外交 cct98912 :   俄羅斯 老板娘 : 美帝 日薄西山 雇不起 佣人 ！ 雾 霾 中 呼吸 : 撑 雨伞 人 都 木有 瞧不起 
 愚童__: 解决不了 事情 应对 不了 ！ 糟糕 2019 年 ～ 本身 一个 无比 悲观 人 负 能量 整体 充斥 命运 生活 还 一次次 捉弄 有时候 都 崩溃 想想 家里 一个 撑下去 ！ 好 累 真的 累 ～   
 苏毓七七: 家 撑下去 不 感情 孩子 现代人 过不下去 还要 孩子 硬撑 ？ ！ 无趣 无爱 浑浑噩噩 ～   
 爱威爱然: 承认 我过 一点 不好 很多 真的 都 熬 不   快要 崩溃 不 压力 改变 都 太 好多 事情 真的 接受 不了   无力 抗拒 只能 哭 完 再 爬起来 老老实实 走 这辈子 从来 没 坚强 大小 坎 都 死 撑过去   
 cool小拉: 讲评 试卷 气绝 快到 暑假 撑不下去   
 我要当项目经理: 好 难 太难 真怕 撑不下去   
 Xiao年轮: 撑不下去 很 幸福 谢谢   
 兔儿买白菜: 天上 小雨 撑 伞 散步   想 笨蛋 不 主动 ？ 路过 小桥 时   故意 伞 扔 河水 里 愣住   笑 说 一个 人 淋雨 ？   恍然大悟 咻 一声 伞 扔下去   
 一直都要哈哈哈: 柳暗花明 才 我快 撑不下去 ！ ！ ！   
 障障小宝贝_: 挂水 快好了   荷包 撑不下去   
 幸福小四毛: 弟弟 实在 太 懂事 同学 去 上海 找 工作 碰到 中介 骗 400 块钱 钱交 工作 没想到 一进 宿舍 傻眼 墙 黑 吓人 返潮 10 几个 人 打着 地铺 只能 找 工作 跑 上海 无数个 区 选择 去 芜湖 实在 没钱 撑不下去 爸爸妈妈 说 还       展开 全文 c 
 朴燦花ww: 想念 严敏 感觉 鸡条 跑 男 感觉 男人帮 六人 + 严敏 才 极限 挑战 看回 鸡条 鸡条 就算 小猪 艺兴 黄磊 王迅 撑 看不下去 嘉宾 都 很 好 喜欢 原班人马 喜欢 极限 挑战 命   
 Yuri_Blue: 最惨 听到 人 说 撑不下去 回来 都 好像 去 地方 称为 回来   
 原味高MVP: 大学 刚 毕业 生存 酒店 前台 干着 三个 月 晚上 没 睡觉 上班 白天 睡觉 晚上 上班 感觉 快 撑不下去 专业 相关 工作 却 找 不到 非专业 相关 找不着 很 迷茫 不 再 还 撑 多久   2 长沙   ·   南 门口   
 NO_Champion: 快 撑不下去 再 逼 一把   
 我超认真哒: 恰 火锅   感觉 撑不下去   吃点 开心   加油   
 Kkw的杨小妮儿: 累 撑不下去 视频 瞬间 充满 正 能量 王凯 kkw   眼里 全是 
 仔仔糖糖宝贝滴妈: 天气 太 热 天气 去 南京 武汉 真怕 撑不下去   
 ni的甜心: 太热 太 热 胖崽要 撑不下去     
 这世界让你紧张害怕吗: 快要 撑不下去 53 天给 灌 一碗 毒 鸡汤   
 幻以诺: 自闭 撑 很 久 最终 某天 深夜 撑不下去 不 难过 不好过 还 白天 挺 好 晚上 要死 白天 不想 活下去 都 一瞬间 做 爱与恨 一瞬间 再 做 一瞬间 脑袋 像是 光速 回忆 发生 事 直觉 判断       展开 全文 c 
 帅气机智哒浴帽超人酱: ？ 真的 撑不下去 委屈 要命 当初 分配 这项 工作 本来 超出 能力 明明 是因为 人 去 做 去 做 才 会 分配 没法 拒绝 想 学习 提升 不 这项 工作 高 精细 只用 做 一件 事       展开 全文 c 
 Tiger彬彬: 承认 我过 一点 不好 很多 真的 都 熬 不   快要 崩溃 不 压力 改变 都 太 好多 事情 真的 接受 不了   无力 抗拒 只能 哭 完 再 爬起来 走 这辈子 从来 没 坚强 大小 坎 都 死 撑过去       加油   
 童心未泯www: 生活 不易 奔跑 前行 路上 沉浸 日复一日 忙碌 里 全家 生计 打拼 再 辛苦 ； 一次次 快 撑不下去 偷偷 告诉 再撑 好 人 努力 打拼 才能 越 走 越顺   
 俆_dan: 集市 上 鱼   水分 蒸发 差不多   时常 就要 撑不下去   前途 未卜 痛苦 里 周而复始   死   偏 不肯 温柔 豢养   
 onedaylme: ioi 重组 官宣 wtmxsl 人 真的 太 搞笑   请 夏 都 撑起 solo   都 做出 成绩 才 真的 重情 重义 好   国内 蹚 浑水 混不下去 败 名声   真的 占 大 便宜 好   居然 有人 说 话   真的 生气   便宜 还 卖乖   
 别人口中的王村姑: 异地 才 刚刚开始 撑不下去 一个 人 走 一个 人 ！   
 始冰卍廿贰: 月 月初 都 说   月 会 好 月 月底 告诉 说 下个月 会 好   才 真的 好   撑不下去 Hello 七月   
 花花丸子头: 轻松 筹 爱心 接力 ！ - 才 11 岁 爸爸 撑下去 ！   -   轻松 筹   轻松 筹   爱心 人士 你们好 感谢 打开 求助信 袁子翔 11 岁 爸爸 58 岁 爸爸 总和 别人 说 儿子 缘分 浅 ...   O 网页 链接   
 BOICE_Ho: ！ 撑不下去         
 爱笑又爱哭的小雯子: 人生 总有 一段 孤独 走 时光 理解 撑下去 好   
 七七吃饱才是真的快乐: 撑不下去   
 早睡第一名_: 球球 真的 撑不下去 脑壳 疼得 连成一片 呼吸 发累 胸口 一团 闷火 捂着 耗着 一点一点 吃 干 抹 净   
 韩畅刘芯言今天结婚了吗: 大概 策划 暑假 干什么   特别 特别 想 回家   多天 都 熬过去   剩 4 天 撑不下去   好 想 回家   
 花花丸子头: 轻松 筹 爱心 接力 ！ - 才 11 岁 爸爸 撑下去 ！   -   轻松 筹   轻松 筹   爱心 人士 你们好 感谢 打开 求助信 袁子翔 11 岁 爸爸 58 岁 爸爸 总和 别人 说 儿子 缘分 浅 ...   O 网页 链接   
 奇思妙想呆毛: 家 心灵 港湾 这句 话 字面 理解 一个 人 原生 家庭 独立 欲望 日后 会 独立 孩子 之间 最 融洽 相处 关系 不 涉及 利益 孩子 在外 打拼 再苦 再 累 绝不 父母 积蓄 度日 实在 撑不下去 回家 家人 想想 向往 生活 hp 满格 振作精神 父母 孩子 操心 却       展开 全文 c 
 qi510678878: zxc668   杨浩走 悬崖 第一个 跳下去 嗵 一声 跌入 深深 河水 早 黑漆 涛 难以 视物 落水 准确 时间 猛地 沉入 水中 差点儿 便 喝 上 一口 河水 摒住 呼吸 浮出 水面 时 猛力 划水 强撑 不让 顺水 飘 太快 仰头 崖 上 大叫 石 兄弟 本帅 平安无恙 下   
 一林Fan:  电视剧 陈情 令 魔道淑芬 死忠 粉 当初 肖战王 一博 演剧 版时 看 还 去 看 帅帅 视频 看 肖战 剧照 接受 wyb 感觉 气场 撑 不 去 找 跳舞 视频 小 哥哥 跳舞 真的 帅死 （ 剧里 越往后 看越 ） 出 mzy 事后 真的 气死 会想 去 看       展开 全文 c 
 用户5508185737: 心情 超级 差 别人 轻易 事 ？ 却 努力 2 年 都 不行 身体 每况愈下 生病 才 健康 多么 宝贝 找 真的 好 累 快 撑不下去   2 成都   
 戏人老朽: 哥哥     都 近乎 崩溃 状态 下 度过     都 问     我能 撑下去     我能   支撑力 太小       选择     逃不掉   别人 每替 惋惜     更 疼       想想     我会 好受 点         （ 希望 不 小心 掉 进 沼泽地     明年 走 花路 ） 
 尤尤尤其_: 好 想 过生日 ！ 想 人 牵挂 ！ 都 充满 好听 情话 嘻嘻 ！ 蛋糕 还 甜 祝福 期望 ！ 撑不下去 盼 生日 十八 十八 ！ 晚安 ！   
 盒洛洛落地不成盒: 撑下去 加油 明天 晚上 凤凰 不 恩施   
 凌小晚: 感觉 快 撑不下去   
 Cibudayiyiyi: 七月 才 暑假 第一天 撑不下去 感觉 人 精疲力尽 心力交瘁 有时候 真的 真的 不想 累   
 安杰拉在尼比鲁: 去 wasaga   beach 总 wasaga 这名 一点 都 不 英语 为啥 湖边 会 小 松树 大包 小裹 买 一堆 零食   一顿 KFC 吃 撑   零食 塞 不 Canada   Day   
 兔兔仙鹅: 真的 受不了 电视剧 演技 剧情 时间 线烂 坨   xz 颜撑 都 看不下去 真的 再 看 吐 称呼 乱 莫名其妙 机兄 就算 十几岁 蓝湛 含光君 几个 ？   
 林子薇薇V: 很快 就要 撑不下去   
 有券君: 19.9 入   雅集     玻璃杯 子     办公室 茶杯 - - - - - - 昨天 种草 推荐 测评 事 失败 李遇 春 商量 都 这阵子 先 跟着 少东主 安心 做买卖 待和裕升 实在 撑不下去 再 想法子   
 杨漂漂TT: 承认 我过 一点 不好 很多 真的 都 熬 不   快要 崩溃 不 压力 改变 都 太 好多 事情 真的 接受 不了   无力 抗拒 只能 哭 完 再 爬起来 老老实实 走 这辈子 从来 没 坚强 大小 坎 都 死 撑过去     2 兰州   
 简单学习网允儿老师: 真的 一点一点 都 不想 学习 不 学习 不 会 时代 淘汰 别人 讨论 会 说 只会 干什么 都 世间 机会 会 选择 只能 撑下去 知识 难 看 几遍 能看懂 看 看不去 逃避 能看懂 ？ 都 努力       展开 全文 c 
 不专业的奶爸: zxc668   男人 唯唯喏喏 不吭声 妇人 叹 口气 道 放心 一日 夫妻 百日 恩 瘫 瘸 都 抛下 一个 妇人 这家 撑不下去 女人 说 说 呜呜 哭泣 男人 长长地 叹息 一声 道 小东 别哭 对不起 那心 留下 ？   
 用户6964176888: 撑下去 责任 未 完 不 想 不如归去 ！   
 我喜欢所以你喜欢: 想 说 长大 好多 烦恼 小时候 开心 话到嘴边 憋 回去 天天 都 吃苦 小时候 很 艰难 时刻 小时候 小口 小口 吃苦 长大 张大嘴 吃 承受 苦 能力 变强 才 会 捧 开心 大笑 吃苦 哪有 尽头 苦尽甘来 撑不下去 力气 向前 看 倒霉       展开 全文 c 
 Curly-Fool:  名 侦探 柯南 每次 刷到 这集 心疼 死 真的 看不下去 柯南 重 感冒   难受 还 强撑 推理 会 照顾 ！ 小兰 不 关心 好 想 抱 沉重 身体 不用 站 难受 晕倒       展开 全文 c 
 ABC别想太多: 多么 硬 都 不得不 低头 好 恨 两个 声音 一个 真的 受够了 趁早 快刀斩乱麻 一个 再 坚信 老天 考验 撑下去 卡 蛋 动 疼 不动 持续 疼   
 用户7061289074: 难道 传说 中 爱民如子 ？ 感觉 快 撑不下去 
 是亲卿吖: 承认 我过 一点 不好 很多 真的 都 熬 不   快要 崩溃 不 压力 改变 都 太 好多 事情 真的 接受 不了   无力 抗拒 只能 哭 完 再 爬起来 老老实实 走 这辈子 从来 没 坚强 大小 坎 都 死 撑过去     ○ ○ 女头  女头  女 头像       展开 全文 c 
 来一分钱TM糖: 七月 第一天 倦   撑不下去   耗 才 十几个 号   
 繁华6143121420:  晚安 语录 人 独自 前行 任何人 都 帮不上忙 再苦 再 难 撑下去 有时候 真的 想象 还要 强大 微博 贴纸   
 blackwhite__whai: 不认 怂 没 办法 撂倒 我要 加油 撑下去 忍住 上司 神经病 
 悠然_40418: 轻松 筹 爱心 接力 ！ - 行善 一种 轮回 请 救救 女儿 ！   -   轻松 筹   轻松 筹   犹豫 很 久 最终 发起 这次 求助 撑 很 久 实在 撑不下去 求助 人张 自兵 患者 小女儿 张菁 来自 湖北省 襄 ...   O 网页 链接   
 不知名资深互联网网友在线冲浪: 朱一龙 太 好看 浓眉大眼 剑眉 星目 活过来 拢 龙 宝贝 不 营业 指望 军装 还 撑下去 朱一龙 
 我的西皮可能每天都很甜: 快 到期 快要 撑不下去   
 遇见我的人生灯塔: 发现 好 登西 ！ 哈哈哈哈 哈哈哈 哈哈哈 彭磊 太 有趣 快 考完 我要 本书 读完 看太有 负罪感 赶紧 考完 我要 疯 撑不下去 难熬 日子 还要 两周   
 羽墨青丝: 感觉 好像 撑不下去   
 比比比斯鲁: 五月 青枫 : 93 级 ！ 不 62 级 高资   还 撑下去 
 星星县的阿狸: 休 一周 再 上班 心情 沉重 浑浑噩噩 点数 起床 刷牙 打理 看着 乱糟糟 房间 想着 即将 面对 人和事 撑不下去 这份 工作 带给 期待 化为 逃避   
 冰淇淋泡芙真的超甜: 这家 人 都 矛盾 都 解决不了 吵架 吵架 抑郁症 抑郁症 喝酒 家暴 不知 错 生活 毫无 盼头 真的 想 哭 糟糕 情绪 我该 撑下去   
 奶油五香炒瓜子: 新 一周 朱一龙 才能 撑下去 没关系 不 OK 旧图 够 看   
 单Genius: wow 看 韩剧 啊啊啊   听见 声音 简直 消除 韩剧 偏见 .... 最 讨厌 电视剧 感觉 bbbbb   感觉   妈   绝   太棒了   简直 爱死 李宝英 姐姐  李宝英 李钟 硕 腿   尝试 看 太阳 后裔   第五集 撑不下去 ... 感觉 太 无聊       展开 全文 c 
 FREEDOM平: 太 心声 太 真实   貴方 と の 時間 は   い ま や 夢 の よ う   etnw 两年 半   想到 收录 live 都 收录   疯狂 流泪   怀疑 到底 去 看 一切都是 臆想 梦 数着 能见 日子 撑下去   还 高强度 追 多久   最 喜欢 solo   live   出张 碟 求求   说 都 烦 
 妳是我唯一想要的了解-: 生活 困苦 想 都 撑过来 走 K 双 门洞 惠化 洞 （ 口琴 版 ） （ Cover 请 回答 1988 ）   ( 网易 云 音乐 )   
 我说是就是259695: 撑不下去 拉拉   
 Yikefeizifen·: 再 不 拉屎 我撑 躺 不   
 幻想让生佛更美腻: 老天 帮帮我 真的 帮帮我 感觉 快 撑不下去   
 Ziho智豪: 感觉 情怀 快 撑不下去 哈哈哈哈 
 重新遇见了你: 我快 撑不下去 开心 不 开心 装作 开心 在乎 人 就要 吵架 扬言 离开 ？   
 把脉小王子: 一整天 高强度 工作 我要 一杯 冰 咖啡 gogogo   补充 能量   一整天 快要 撑不下去 偷偷 手机 刷 一会 微博 一口 仙气 难撑   2 东莞 · 7 咖啡   
 枭不拉屎大王: 致残 打击     信心     撑不下去   
 wxf_203: 想念 严敏 第一期 播 还 发微 博说 极 挑 一如既往 搞笑 还 劝 网友 都 看不下去 感觉 极 挑 几个 人 死撑 丧失 点开 冲动 颜王 再 美 都 再 挽回   
 我堕入情网你却在大排档: 每次 撑 不   撑   会   好像 没什么 不 Dream   It   Possible - Delacey   
 再来一杯绿茶: 不想 撑下去 好 累 感情 、 事业 、 生活 、 家庭 一个 人撑 真的 好 累 做 值得   
 Allvww: 几天 调节 失败 快 撑不下去   
 好的呀好看呀: 撑不下去 只能 告诉 死 不起   
 蔡長壮: 感觉 一个 深闺 怨妇 见到 不 抱怨 还 不少 相比 人 聊天 更 倾向 怼 人 骂人 想 吐 槽 一天天 上课 课 内容 大于 意义 可过 这阵儿 意义 大于 内容 第二次 重来 那种 感觉 快 撑不下去   
 我怎么这么爱狗血: 第九集 第十集 好 难看 ！ ！ ！ 配角 好尬 好尬 陈情 令   连续 发了 两个 微博来 吐 槽 撑不下去   2 苏州   
 现实浪漫主义: 快点 考完 放肆 找 哭 真的 撑不下去   
 一朝一暮是茶欢: 2019 年 一半 上半年 结束 时间 过得 很快 小卢 同学 快 半年 有时候 很久 有时候 没多久 期间 发生 大大小小 很多 事情 吵吵闹闹 很 有时候 实在 过不下去 才 几个 小时 想 想到 不行 晚上 都 撑 不 脾气 很 爆       展开 全文 c 
 仙女觉得人间太险恶: 喝 三杯 咖啡 一罐 红牛 我要 撑不下去   
 呀呼嘿哈哈啦哦: 永远 懒洋洋 自由 向往 自由 勤奋 努力实现 更 广阔 人生 下半年 撑不下去 记得 这句 话   
 encounter晨曦: zxc668   杨浩 摇头 道 一鼓作气 ？ 攻城 之战 哪有 三天 五天 十天 半月 ？ 连番 大战 之下 兵 铁打 哪有 不累 不乏 再者说 刚刚 招纳 降兵 扩张 大 地盘 大 一块 肥肉 吞下去 总得 稳 稳妥 妥地 化作 腹中 食物 才 好 想要 一口 吃 成个 胖子 还 不 撑   
 Hello米小乐:   一本   有壁 够 撑下去 ！ ！ 明天 名 场面 玫瑰 吻 就要   激动 睡不着 哈哈哈哈   
 梦小盈盈: 想不到 吃 一盘 半 龙虾 吃 喝 好多 鸡汤 还 吃 三个 水饺 两块 蛋糕 吃 西瓜   超甜 超多水 饭局 九点半 结束   还 撑 躺 不 吃 付出代价   2 淄博   
 TONGJINLING59:   才 更 热爱生活 生活 灰色 都 不 撑下去   
 shine想过: 担心 老钟 身体 担心 指南针 撑下去 不 担心 毕竟 死立 执 死缓 差别 恨   
 三叔炒股娶老婆: 想下 下不去 利好 撑 想 上 上 不 去 解套 跑 路 很多 也许 选择 方向 明天 会 突破 看 方向 更强 原以为 谈判 会 全场 利好 大 力度   
 _相葉豌豆酱: 较量 一个月 都 撑不下去 确实 办法 一个 人 生活 废物 信誓旦旦 行 每次 大事 小事 只会 哭哭啼啼 解决问题 方法 可笑 幼稚 不了 外卖 选择 不吃 天然气 坏 洗 冷水澡 天气 不好 不到 车 上班 请假 不去 上班 一个 没用       展开 全文 c 
 17拾壹: 想 大概 撑不住 太久 一味 万念俱灰 大不了 楼上 跳下去 一了百了 站 九楼 阳台 树 郁郁葱葱 想 飞下去 树枝 尖锐 刺透 身体 念头 发抖 害怕 求生欲 想 活着 世人 只 矫情 拥有 健康 身体 却 不 爱惜 偏偏 浪费 生命       展开 全文 c 
 Hey就不能找个大点的碗么: 上海 垃圾 分类 扔 错 罚款       实行 垃圾 分类 本来 吃不完 外卖 通通 逼 撑下去     好 ！ 烦 ！   
 释怀__那紫色: 张艺兴脑 洞大开   吃火锅 嗑瓜子 还要 搞个 炕   暖心 支招 李荣浩 主持 技巧 张艺兴 下次 搞 一个 火锅 主持 谈笑风生 李荣浩 马上 一个 人 讲 五组 实在 撑不下去 cue 一下张 艺兴 太干 说 召唤 不荣艺 组合 李荣浩 俩       展开 全文 c 
 小柠理想型: 真的 撑不下去 算了吧   
 行走的体型裤: 想发 下半年 第一天 好 七月 你好 [ 大 侦探 皮卡丘 微笑 ] 想起 还 花 打开 支付宝 看 看卡 余额 这回 真的 透支 hhhh 距离 开 工资 20 天 撑下去 体型 裤 语录   上个月 麻麻 救济 总 麻麻 救济 班上 光出 不进 吃不消       展开 全文 c 
 将定沪一族: 写给 九句 话 撑不下去 [ 泪流满面 ]   
 unhappygoose: 脚 踩 体制 内 拳打 流量 圈   出国 唱 跑调 海外 无人 晓   出圈 全靠 假唱 逼格全 凭粉 吹   原创 想出 好剧 还 跨界 撑场   借沪圈 雄心豹胆 编不 反正 小鹅 不   
 换个昵称不想被别人找到: 世界末日 撑不下去   
 冷漠的大黄蜂: 浙大 博士 跳江 自杀 孩子 撑不下去 几张 图 ！ O 网页 链接   
 叁贰芯: 中午 吃小面 味觉 不对劲 想想 吃 擀 面皮 擀 面皮 念 想 吞下去 半碗 面 转头 吃 韭菜 鸡蛋 馅儿 饺子 嚯 嚯 嚯 饺子 才 真 爱 ！ 已然 来不及 胃 小面 擀 面皮 撑满   
 Cececelia_: 两天 心态 真的 一点 爆炸 一点 受不了 生活 上 周末 班好 不 值得 想想 不值 再 一点 动力 都 信念 支撑 好 累 还要 撑 三个 月 才能 熬 到头 两个 月 不到 一点 计划 都 提前 考 多天 压力 一下子 涌上来 才 好 崩       展开 全文 c 
 大裸朵: 点 一份 盖饭 盖 点菜 肉 少 亲妈 都 不 一份 盖饭 盒子 白米饭 两片 （ 夸张 两片 ！ ） 菠菜 两块 土豆 狠 一点 扒拉 菜 坨 米饭 思考 扔 垃圾 还 换个 盒子 全 吃 完 好撑 垃圾 分类 使人变 胖   值得 开心 都 干 垃圾       展开 全文 c 
 吴泡泡是好蛋蛋: 好累     董加伟     一件 事情 都 撑不下去   
 莳桉啊: 水 没 脚踝 大厦 门 檐下 堵 好多 人 一个 中年男人 撑伞 走 一个 姑娘 跟前 伞 递给 说 背 一会儿 开门 还 打着 伞 别淋 很 自然 蹲下去 背 孩子 趟 进雨中 吸引 目光 爸爸 穿 皮鞋 笑 得宠 溺 姑娘 快 爸爸 高 穿着 凉鞋 还 不 懂 幸福   
 EachOfYou: 时期 其他人 都 结婚 分开 说 两天 充实 地像 半年 不想 离开 撑不下去 笑 几天 过得 痴痴 醉醉 上次 好好 5 年 那年 大一 都 刚 聊 初中 上学时 趣事 放下 骄傲 带 一身 疲惫 一个个 好 姑娘 感情 路上 跌       展开 全文 c 
 JoJo姣姣吖: mo   mo   这辈子 做 错事 太 活 好 累 真的 撑不下去 发生 意外 想 做俊俊 干妈 照顾 都 去 我家 看 爸妈 此条 信息 长期有效 常用 密码 都 名字 全拼 加 手机 后 四位   
 ·樱花草莓星冰乐·: .... 孟 女士 真的 看剧 阻力 我快 撑不下去   
 绝版AD钙: 越来越 想 回家 感觉 快 撑不下去   2 福州   
 青二才小十: 推文   你养 猪 做 鸭 萧九凉 林向黎 家庭 原因 大学 退学 回家 乡 舅舅 安排 下当 一名 代课老师 母亲 病 表弟 唆使 当鸭 去 买 鸭 简 博士 养猪 老板 一段 努力 扮好 包养 角色 喜欢 上 奢求 爱 却 误会 只想 包养 默默 撑起 天       展开 全文 c 
 yangqqingssss: 不 撑下去 没   
 多多是doodle: 周六 野 Day93 下半年 第一天   大姨妈   10min 改善 斜方 肌 10min 臀腿 5min 瘦 手臂 30 反式 撑体   几天 再 恢复正常 回想 上半年   105 - 88 - 92   不再 专注 我要 减肥 一件 事   不再 过度 节食   世界 上 完美 身材   试着 学会 接纳 不 完美   努力 追求 更 健康 生活 方式   坚持下去       展开 全文 c 
 nxxyeah: 想 干 文职 感觉 肉体 撑不下去 看 电脑 感觉 脑子 都 炸   
 妙木山山民:  进击 巨人 第三季 part2 结束 海 真相 、 代价 依旧 血淋淋 残酷 世界 残酷 美好 残酷 永远 都 美好 会 珍惜 美好 ？ 人 不 沉醉于 东西 估计 都 撑不下去 找到 沉醉 东西 ？   
 Angel34724: 承认 我过 一点 不好   很多 真的 都 熬 不   快要 崩溃   不 压力   改变 都 太   好多 事情 真的 接受 不了   无力 抗拒   只能 哭 完 再 爬起来 老老实实 走   这辈子 从来 没 坚强   大小 坎 都 死 撑过去   
 只有大脸: - ShineWu   撑 吃 不 饼 
 技术部新员工: 不好意思 撑不下去   
 比比比斯鲁: 五月 青枫 : 93 级 ！ 不 62 级 高资   还 撑下去 
 俊櫋: 今日 快乐   说 下午 学不 看 一集 电视剧   舍友 说 图书馆 平板 干 事情 超   前 几天 很 远 一个 男生 平板 玩 蜘蛛 纸牌   一个 舍友 说 手机 里 下过 扫雷   袁 爷爷 吃 太饱   吃饱 撑 干 事 哈哈哈 哈哈哈 哈哈哈 哈哈哈 哈哈哈 哈哈哈 哈哈哈 哈哈哈   
 软软小懒: 粉上 半年 经历 很多 心累 会 想着 不 感觉 撑不下去 依旧 真的 放不下 喜欢 依旧 想 看着 依旧 舍不得 想 会 静静的 等待 默默 背后 做些 力所能及 事情 时光 不语 静待 花开   
 Bevshyu-: 求求 认真学习   好好 努力   真的 再 玩 吃 真的 很肥 开心 呜呜 再 难 加油 撑下去 M 大王 巡山 : 想要 都 拥有 得不到 都 释怀 苍南 派 : 快乐 工作 快乐 生活 雨 玲玲 zjl : 愿 努力 不负 期望 ali _ thin : 求 减肥 Tiger 公子 : 再 生病 
 江染jiang: 梦想 天 见鬼   求求 阮东廷 快 碰见 我快 撑不下去 
 Ming明贼爱你: 始 始终 终 脆弱 撑不下去 人 都 一个   
 蘑菇爷爷的老花镜: 做做 小孩 做 小孩 希望 坚强 很多很多 很多 耐心 无限 耐心 撑不下去 希望 包容   
 係贝拉唔係备啦: 这段 说 普通话 听 不 ！ 尴尬 
 默哀心底: 我俩 关系 全靠 硬撑   终于 撑不下去   祝 越来越 好   
 王靳一北: " 分享 浙大 博士 跳江 自杀 孩子 撑不下去 19 张 照片 ,   快 来看 ！   |   O 网页 链接   " 
 Boom_LD: zxc668   龙王 小儿子 龙云略 思忖 提议 道 爹 要知 先 休兵罢战 试试 杨浩 心意 至少 借此机会 将士 稍作 歇息 恐怕 真的 撑不下去   
 陳简单100317: 有种 感觉 段 友情 撑不下去 ！ ！ 开 一丝 玩笑 每次 聊天 还 想想 哪句 说 哪句 不 说 ！ ！ 不想 样子 ！ ！ 我累 真的 累 放弃 ！ ！ 祝好 ！ ！ 友情   
 猥琐叔叔锕: 撑下去 回忆 专用 小 马甲 : 好滴 朋友 奇葩 : 好 ！ 张奶霞 : 祝福 ！ 锦鲤 蛋 : 一条 都 开心 ！ 糗 事 bot : 不 希望 渣 蜀黍 : 加油 ！ 没 : 核仁 布朗 尼 : ！ 夏正正 :   都 刚刚 好 黄濑濑濑濑 : 都 一帆风顺 
 南部煎饼: 有时候 很多 事情 都 不太想 别人 说 只 想 撑 偶尔 撑不下去 稍微 自言自语 nb   
 鸭梨大dd: 晚上 去 九 田家 吃 烤肉 撑 不行 回家 后 洗漱 完毕 躺 床上 饿 吃面 不 去 小狗   去   
 也没有很慌: 有感而发 《 shang 瘾 看 好尬   演员 尬 剧情 尬 台词 尬   会 好   看 两集 撑不下去 ... wyb 好绝 男 （ 暴风 流泪 ）   
 活在淡水里的咸鱼: 绝美 嗓音 绵羊 0318 : 学不 这歌 撑 太绝 感叹 梨 阿琳 : 不醉 死 声音 里   ♀ 
 达石华: 《 儒 释道 文化 浙大 博士 跳江 自杀 孩子 撑不下去 15 张 照片   ! O 浙大 博士 跳江 自杀 孩子 撑不下去 15 张 照片   !   
 橘子苞米花蔚: 撑不下去 
 堂本_LTVXQ: 自诩 老剧粉 好歹 一个 从小 学习 古典音乐 至少 去 听 一场 交响乐 初中 就入 音乐剧 坑 人 巴不得 多点 人进 剧场 看 各种类型 剧 怕 哪一天 剧院 撑不下去 倒闭 南京 场 写给 人 信里 都 说 谢谢你们 更 人 走进 剧场 恨不得 声 人写 八百 封信 谢谢 推广       展开 全文 c 
 Okasiaaan: 啊啊啊 真的 好累 好 无力 真的 快 撑不下去 加油 更好 重聚 疏远 更好 我会 慢慢 走向   
 用户6767380645: 才 没用 垃圾   「 真的 撑不下去 」 啜泣 脸 埋进 双手 拍 肩膀 鼓励 「 撑下去 ！ 难道 忘 时 我俩 许下 誓言 ？ 300 一个 人 自助餐 ！ 」   
 想不到明天的明天: 每次 想 吃 东西 肚子 都 很饱 很撑 真的 饿 反倒 都 吃 不   
 VivienneMe: 陈情 令   不行 撑不下去 弃 Wi - Fi 潇洒不羁 少年郎 娇俏 可人 小 郎君   
 就打你的脸哼:   说好 转运   晚上 感受 楼下 老年 妇女 满满的 恶意 爷爷 状态 好多 早起 动力 ！ 希望 爷爷 撑下去 ... 起码 撑 毕业   哭   我要 坚强 ！ 加油 ！   
 啊睿啊Aria: 每次 压力 大到 撑不下去 发 一发 wyj 丑照 舒服 ！   ！   
 